Squire's	no collision
Journeyman's	no collision
Reaver's	no collision
Mercenary's	no collision
Champion's	no collision
Conqueror's	no collision
Emperor's	no collision
Dictator's	no collision
Heavy	no collision
Serrated	no collision
Wicked	no collision
Vicious	no collision
Bloodthirsty	no collision
Cruel	no collision
Tyrannical	no collision
Merciless	no collision
Glinting	[4]
Burnished	[4]
Polished	[4]
Honed	[4]
Gleaming	[4]
Annealed	[4]
Razor-sharp	[3]
Tempered	[3]
Flaring	[3]
Heated	[6]
Smouldering	[6]
Smoking	[6]
Burning	[6]
Flaming	[6]
Scorching	[6]
Incinerating	[6]
Blasting	[6]
Cremating	[5]
Carbonising	[1]
Frosted	[5]
Chilled	[5]
Icy	[5]
Frigid	[5]
Freezing	[5]
Frozen	[5]
Glaciated	[5]
Polar	[5]
Entombing	[5]
Crystalising	[1]
Humming	[5]
Buzzing	[5]
Snapping	[5]
Crackling	[5]
Sparking	[5]
Arcing	[5]
Shocking	[5]
Discharging	[5]
Electrocuting	[5]
Vapourising	[1]
Catalysing	[3]
Infusing	[3]
Empowering	[3]
Unleashed	[3]
Overpowering	[3]
Devastating	[2]
Malicious	[2]
of Skill	[2]
of Ease	[2]
of Mastery	[2]
of Renown	[1]
of Acclaim	[1]
of Fame	no collision
of Infamy	no collision
of Celebration	no collision
of Needling	[1]
of Stinging	[1]
of Piercing	[1]
of Puncturing	no collision
of Penetrating	[1]
of Incision	[1]
of Ire	[2]
of Anger	[2]
of Rage	[1]
of Fury	[1]
of Ferocity	[1]
of Destruction	[1]
of Acrimony	[2]
of Dispersion	[2]
of Liquefaction	[2]
of Melting	[2]
of Dissolution	[2]
of Waning	[1]
of Wasting	[1]
of Deteriorating	[1]
of Atrophying	[1]
of Disintegrating	[1]
Apprentice's	[1]
Adept's	[1]
Scholar's	[1]
Professor's	[1]
Occultist's	[1]
Incanter's	[1]
Glyphic	[1]
Runic	[1]
Searing	[1]
Sizzling	[1]
Blistering	[1]
Cauterising	[1]
Volcanic	[1]
Magmatic	[1]
Pyroclastic	[1]
Xoph's	[1]
Bitter	[1]
Biting	[1]
Alpine	[1]
Snowy	[1]
Hailing	[1]
Crystalline	[1]
Cryomancer's	[1]
Tul's	[1]
Charged	[1]
Hissing	[1]
Bolting	[1]
Coursing	[1]
Striking	[1]
Smiting	[1]
Ionising	[1]
Esh's	[1]
Magister's	[1]
Flame Shaper's	[1]
Frost Singer's	[1]
Thunderhand's	[1]
Mad Lord's	[1]
Lithomancer's	[1]
of Talent	[3]
of Nimbleness	[3]
of Expertise	[3]
of Legerdemain	[2]
of Prestidigitation	[1]
of Sortilege	[1]
of Finesse	[1]
of Menace	no collision
of Havoc	no collision
of Disaster	no collision
of Calamity	no collision
of Ruin	no collision
of Unmaking	no collision
of Burning	[1]
of Combusting	[1]
of Conflagrating	[1]
of the Inclement	[1]
of the Bleak	[1]
of the Boreal	[1]
of the Gelid	[1]
of Heartstopping	[1]
of the Earnest	[1]
of the Fervid	[1]
of the Ardent	[1]
of the Zealous	[1]
of the Fanatical	[1]
of Seeping	[1]
of Spilling	[1]
of Phlebotomising	[1]
of Hemorrhaging	[1]
of Exsanguinating	[1]
Paragon's	no collision
Fletcher's	no collision
Sharpshooter's	no collision
of Splintering	[1]
of Many	no collision
Lava Conjurer's	no collision
Winter Beckoner's	no collision
Tempest Master's	no collision
Splintermind's	no collision
Tecton's	no collision
Combatant's	no collision
Weaponmaster's	no collision
Hale	[4]
Healthy	[4]
Sanguine	[4]
Stalwart	[4]
Stout	[4]
Robust	[4]
Rotund	[4]
Virile	[4]
Athlete's	[3]
Shining	[5]
Glimmering	[5]
Glittering	[5]
Glowing	[5]
Radiating	[5]
Pulsing	[5]
Seething	[5]
Blazing	[4]
Scintillating	[3]
Incandescent	[3]
Resplendent	[2]
Dazzling	no collision
Magpie's	no collision
Pirate's	no collision
Dragon's	no collision
Perandus'	no collision
Exalter's	no collision
Vulcanist's	no collision
Rimedweller's	no collision
Stormbrewer's	no collision
Behemoth's	no collision
Provocateur's	no collision
of the Brute	[1]
of the Wrestler	[1]
of the Bear	[1]
of the Lion	[1]
of the Gorilla	[1]
of the Goliath	[1]
of the Leviathan	[1]
of the Titan	[1]
of the Gods	[1]
of the Mongoose	[1]
of the Lynx	[1]
of the Fox	[1]
of the Falcon	[1]
of the Panther	[1]
of the Leopard	[1]
of the Jaguar	[1]
of the Phantom	[1]
of the Wind	[1]
of the Pupil	[1]
of the Student	[1]
of the Prodigy	[1]
of the Augur	[1]
of the Philosopher	[1]
of the Sage	[1]
of the Savant	[1]
of the Virtuoso	[1]
of the Genius	[1]
of the Clouds	[1]
of the Sky	[1]
of the Meteor	[1]
of the Comet	[1]
of the Heavens	no collision
of the Galaxy	no collision
of the Universe	no collision
of the Infinite	no collision
of the Multiverse	no collision
of Plunder	no collision
of Raiding	no collision
of Archaeology	no collision
of Excavation	no collision
of Steadiness	[1]
of Precision	[1]
of the Sniper	[1]
of the Marksman	[1]
of the Ranger	[1]
of the Whelpling	no collision
of the Salamander	no collision
of the Drake	no collision
of the Kiln	no collision
of the Furnace	no collision
of the Volcano	no collision
of the Magma	no collision
of Tzteosh	no collision
of the Inuit	no collision
of the Seal	no collision
of the Penguin	no collision
of the Yeti	no collision
of the Walrus	no collision
of the Polar Bear	no collision
of the Ice	no collision
of Haast	no collision
of the Cloud	no collision
of the Squall	no collision
of the Storm	no collision
of the Thunderhead	no collision
of the Tempest	no collision
of the Maelstrom	no collision
of the Lightning	no collision
of Ephij	no collision
of the Lost	no collision
of Banishment	no collision
of Eviction	no collision
of Expulsion	no collision
of Exile	no collision
of Bameth	no collision
of the Crystal	[1]
of the Prism	[1]
of the Kaleidoscope	[1]
of Variegation	[1]
of the Rainbow	[1]
of the Span	no collision
Fecund	[2]
Exemplary	no collision
Quintessential	no collision
Flawless	no collision
of the Newt	[4]
of the Lizard	[4]
of the Flatworm	[4]
of the Starfish	[4]
of the Hydra	[4]
of the Troll	[4]
of Ryslatha	[4]
of the Phoenix	[3]
of Recuperation	[2]
Baroness's	no collision
Viscountess's	no collision
Marchioness's	no collision
Countess's	no collision
Duchess's	no collision
of Motivation	no collision
of Coercion	no collision
of Incitation	no collision
of Agitation	no collision
of the Administrator	no collision
of the Rector	no collision
of the Overseer	no collision
of the Taskmaster	no collision
of Coordination	no collision
of Collaboration	no collision
of Integration	no collision
of Orchestration	no collision
of Harmony	[1]
of Adjustment	no collision
of Acclimatisation	no collision
of Adaptation	no collision
of Evolution	no collision
of Metamorphosis	no collision
of Bandaging	no collision
of Stitching	no collision
of Suturing	no collision
of Fleshbinding	no collision
Lacquered	[4]
Studded	[4]
Ribbed	[4]
Fortified	[4]
Plated	[4]
Carapaced	[4]
Encased	[4]
Enveloped	[3]
Distilling	no collision
Condensing	no collision
Magnifying	no collision
of the Godslayer	no collision
of Refilling	no collision
of Restocking	no collision
of Replenishing	no collision
of Pouring	no collision
of Brimming	no collision
of Overflowing	no collision
of Sipping	[1]
of Tasting	no collision
of Savouring	no collision
of Relishing	no collision
of Reveling	no collision
Reinforced	[1]
Layered	[1]
Lobstered	[1]
Buttressed	[1]
Thickened	[1]
Girded	[1]
Impregnable	[1]
Oyster's	[3]
Urchin's	[3]
of the Blur	no collision
of Grandmastery	no collision
of Lioneye	no collision
of Esprit	no collision
of Perpetuity	no collision
of Vivification	no collision
of Youth	no collision
of Everlasting	no collision
Shade's	[1]
Ghost's	[1]
Spectre's	[1]
Wraith's	[1]
Phantasm's	[2]
Nightmare's	[1]
Mirage's	[1]
Agile	[3]
Dancer's	[3]
Acrobat's	[3]
Fleet	[3]
Blurred	[3]
Phased	[3]
Vaporous	[3]
Flea's	[2]
Fawn's	[2]
of Rebuttal	[1]
of Snuffing	[1]
of Revoking	[1]
of Abjuration	[1]
of Nullification	[1]
Protective	[1]
Strong-Willed	[1]
Resolute	[1]
Fearless	[1]
Dauntless	[1]
Indomitable	[1]
Unassailable	[1]
Scrapper's	[1]
Brawler's	[1]
Fencer's	[1]
Gladiator's	[1]
Duelist's	[1]
Hero's	[1]
Legend's	[1]
Supple	[3]
Pliant	[3]
Flexible	[3]
Durable	[3]
Infixed	[1]
Ingrained	[1]
Instilled	[1]
Infused	[1]
Inculcated	[1]
Interpolated	[1]
Inspired	[1]
Blessed	[3]
Anointed	[3]
Sanctified	[3]
Hallowed	[3]
Monk's	[2]
Prior's	[2]
Shadowy	[2]
Ethereal	[2]
Unworldly	[2]
Ephemeral	[1]
Evanescent	[2]
Unreal	[2]
Illusory	[2]
Will-o-wisp's	[3]
Nymph's	[3]
Sylph's	[3]
Cherub's	[3]
Runner's	no collision
Sprinter's	no collision
Stallion's	no collision
Gazelle's	no collision
Cheetah's	no collision
Vigorous	[1]
Rapturous	no collision
Prime	no collision
Impenetrable	no collision
Abating	[1]
Unmoving	[1]
Impervious	no collision
Nautilus's	[1]
Crocodile's	no collision
of Life-giving	[1]
of Convalescence	no collision
of the Watchman	no collision
of the Sentry	no collision
of the Keeper	no collision
of the Protector	no collision
of the Conservator	no collision
Illusion's	no collision
Elusory	[2]
Adroit	[1]
Lissome	[1]
Fugitive	no collision
Ram's	[1]
Ibex's	no collision
Unfaltering	no collision
Abbot's	[1]
Exarch's	no collision
Victor's	no collision
Sturdy	[2]
Resilient	[1]
Adaptable	[1]
Versatile	no collision
Interpermeated	no collision
Beatified	[2]
Consecrated	[1]
Saintly	[1]
Godly	no collision
Incorporeal	no collision
Spirit's	[2]
Eidolon's	[1]
Apparition's	[1]
Taskmaster's	no collision
Overseer's	no collision
of the Polymath	no collision
Acute	no collision
Trenchant	no collision
Perforating	no collision
Incisive	no collision
Lacerating	no collision
Impaling	no collision
of Rupturing	no collision
of Rending	no collision
of Darting	no collision
of Flight	no collision
of Propulsion	no collision
of the Zephyr	no collision
of the Gale	no collision
of Intercepting	no collision
of Walling	no collision
of Blocking	no collision
of the Stalwart	no collision
of the Buttress	no collision
of the Sentinel	no collision
of the Citadel	no collision
of Repairing	no collision
of Resurgence	no collision
of Renewal	no collision
of Revival	no collision
of Rebounding	no collision
of Revitalization	no collision
of Stoicism	no collision
of Resolve	no collision
of Fortitude	no collision
of Will	no collision
of Dulling	no collision
of Deadening	no collision
of Interference	no collision
of Obstruction	no collision
of the Bushfire	no collision
of the Molten Core	no collision
of the Solar Storm	no collision
of Furs	no collision
of the Tundra	no collision
of the Mammoth	no collision
of Impedance	no collision
of Shockproofing	no collision
of the Lightning Rod	no collision
of Regularity	no collision
of Concord	no collision
of the Sempiternal	no collision
of the Deathless	no collision
Chosen	no collision
of the Order	no collision
Catarina's	no collision
Catarina's Veiled	no collision
Elreon's	no collision
Elreon's Veiled	no collision
Gravicius'	no collision
Gravicius' Veiled	no collision
Haku's	no collision
Haku's Veiled	no collision
It's	no collision
It That Fled's Veiled	no collision
Jorgin's	no collision
of Jorgin's Veil	no collision
Korell's	no collision
Korell's Veiled	no collision
Leo's	no collision
Leo's Veiled	no collision
of Aisling	no collision
of Aisling's Veil	no collision
of Cameria	no collision
of Cameria's Veil	no collision
of Hillock	no collision
of Hillock's Veil	no collision
of Janus	no collision
of Janus' Veil	no collision
of Riker	no collision
of Riker's Veil	no collision
Rin's	no collision
Rin's Veiled	no collision
Tora's	no collision
Tora's Veiled	no collision
Vagan's	no collision
Vagan's Veiled	no collision
Vorici's	no collision
Vorici's Veiled	no collision
Essence	no collision
of the Veil	no collision
Veiled	no collision
Citaqualotl's	no collision
Guatelitzi's	no collision
Matatl's	no collision
of Citaqualotl	no collision
of Guatelitzi	no collision
of Matatl	no collision
of Puhuarte	no collision
of Tacati	no collision
Tacati's	no collision
Topotante's	no collision
Xopec's	no collision
The Shaper's	no collision
of Shaping	no collision
The Elder's	no collision
of the Elder	no collision
Crusader's	no collision
of the Crusade	no collision
Redeemer's	no collision
of Redemption	no collision
Hunter's	no collision
of the Hunt	no collision
Warlord's	no collision
of the Conquest	no collision
Subterranean	no collision
of the Underground	no collision
Essences	no collision
of the Essence	no collision
