Enchantment Word of Blades	Normal Labyrinth	Trigger Word of Blades on Hit
Enchantment Edict of Blades	Cruel Labyrinth	Trigger Edict of Blades on Hit
Enchantment Decree of Blades	Merciless Labyrinth	Trigger Decree of Blades on Hit
Enchantment Commandment of Blades	Eternal Labyrinth	Trigger Commandment of Blades on Hit
Enchantment Word of Flames	Normal Labyrinth	Trigger Word of Flames on Hit
Enchantment Edict of Flames	Cruel Labyrinth	Trigger Edict of Flames on Hit
Enchantment Decree of Flames	Merciless Labyrinth	Trigger Decree of Flames on Hit
Enchantment Commandment of Flames	Eternal Labyrinth	Trigger Commandment of Flames on Hit
Enchantment Word of Force	Normal Labyrinth	Trigger Word of Force on Hit
Enchantment Edict of Force	Cruel Labyrinth	Trigger Edict of Force on Hit
Enchantment Decree of Force	Merciless Labyrinth	Trigger Decree of Force on Hit
Enchantment Commandment of Force	Eternal Labyrinth	Trigger Commandment of Force on Hit
Enchantment Word of Frost	Normal Labyrinth	Trigger Word of Frost on Kill
Enchantment Edict of Frost	Cruel Labyrinth	Trigger Edict of Frost on Kill
Enchantment Decree of Frost	Merciless Labyrinth	Trigger Decree of Frost on Kill
Enchantment Commandment of Frost	Eternal Labyrinth	Trigger Commandment of Frost on Kill
Enchantment Word of Fury	Normal Labyrinth	Trigger Word of Fury on Hit
Enchantment Edict of Fury	Cruel Labyrinth	Trigger Edict of Fury on Hit
Enchantment Decree of Fury	Merciless Labyrinth	Trigger Decree of Fury on Hit
Enchantment Commandment of Fury	Eternal Labyrinth	Trigger Commandment of Fury on Hit
Enchantment Word of Inferno	Normal Labyrinth	Trigger Word of Inferno on Kill
Enchantment Edict of Inferno	Cruel Labyrinth	Trigger Edict of Inferno on Kill
Enchantment Decree of Inferno	Merciless Labyrinth	Trigger Decree of Inferno on Kill
Enchantment Commandment of Inferno	Eternal Labyrinth	Trigger Commandment of Inferno on Kill
Enchantment Word of Ire	Normal Labyrinth	Trigger Word of Ire when Hit
Enchantment Edict of Ire	Cruel Labyrinth	Trigger Edict of Ire when Hit
Enchantment Decree of Ire	Merciless Labyrinth	Trigger Decree of Ire when Hit
Enchantment Commandment of Ire	Eternal Labyrinth	Trigger Commandment of Ire when Hit
Enchantment Word of Light	Normal Labyrinth	Trigger Word of Light when you take a Critical Strike
Enchantment Edict of Light	Cruel Labyrinth	Trigger Edict of Light when you take a Critical Strike
Enchantment Decree of Light	Merciless Labyrinth	Trigger Decree of Light when you take a Critical Strike
Enchantment Commandment of Light	Eternal Labyrinth	Trigger Commandment of Light when you take a Critical Strike
Enchantment Word of Reflection	Normal Labyrinth	Trigger Word of Reflection when Hit
Enchantment Edict of Reflection	Cruel Labyrinth	Trigger Edict of Reflection when Hit
Enchantment Decree of Reflection	Merciless Labyrinth	Trigger Decree of Reflection when Hit
Enchantment Commandment of Reflection	Eternal Labyrinth	Trigger Commandment of Reflection when Hit
Enchantment Word of Spite	Normal Labyrinth	Trigger Word of Spite when Hit
Enchantment Edict of Spite	Cruel Labyrinth	Trigger Edict of Spite when Hit
Enchantment Decree of Spite	Merciless Labyrinth	Trigger Decree of Spite when Hit
Enchantment Commandment of Spite	Eternal Labyrinth	Trigger Commandment of Spite when Hit
Enchantment Word of the Tempest	Normal Labyrinth	Trigger Word of the Tempest on Hit
Enchantment Edict of the Tempest	Cruel Labyrinth	Trigger Edict of the Tempest on Hit
Enchantment Decree of the Tempest	Merciless Labyrinth	Trigger Decree of the Tempest on Hit
Enchantment Commandment of the Tempest	Eternal Labyrinth	Trigger Commandment of the Tempest on Hit
Enchantment Word of the Grave	Normal Labyrinth	Trigger Word of the Grave when your Skills or Minions Kill
Enchantment Edict of the Grave	Cruel Labyrinth	Trigger Edict of the Grave when your Skills or Minions Kill
Enchantment Decree of the Grave	Merciless Labyrinth	Trigger Decree of the Grave when your Skills or Minions Kill
Enchantment Commandment of the Grave	Eternal Labyrinth	Trigger Commandment of the Grave when your Skills or Minions Kill
Enchantment Word of Thunder	Normal Labyrinth	Trigger Word of Thunder on Kill
Enchantment Edict of Thunder	Cruel Labyrinth	Trigger Edict of Thunder on Kill
Enchantment Decree of Thunder	Merciless Labyrinth	Trigger Decree of Thunder on Kill
Enchantment Commandment of Thunder	Eternal Labyrinth	Trigger Commandment of Thunder on Kill
Enchantment Word of War	Normal Labyrinth	Trigger Word of War on Kill
Enchantment Edict of War	Cruel Labyrinth	Trigger Edict of War on Kill
Enchantment Decree of War	Merciless Labyrinth	Trigger Decree of War on Kill
Enchantment Commandment of War	Eternal Labyrinth	Trigger Commandment of War on Kill
Enchantment Word of Winter	Normal Labyrinth	Trigger Word of Winter when Hit
Enchantment Edict of Winter	Cruel Labyrinth	Trigger Edict of Winter when Hit
Enchantment Decree of Winter	Merciless Labyrinth	Trigger Decree of Winter when Hit
Enchantment Commandment of Winter	Eternal Labyrinth	Trigger Commandment of Winter when Hit
Enchantment Chaos Damage 1	Cruel Labyrinth	Adds 44 to 64 Chaos Damage if you've taken a Critical Strike Recently
Enchantment Chaos Damage 2	Merciless Labyrinth	Adds 88 to 132 Chaos Damage if you've taken a Critical Strike Recently
Enchantment Chaos Damage 3	Eternal Labyrinth	Adds 120 to 180 Chaos Damage if you've taken a Critical Strike Recently
Enchantment Fire Damage 1	Cruel Labyrinth	Adds 16 to 24 Fire Damage if you've Killed Recently
Enchantment Fire Damage 2	Merciless Labyrinth	Adds 33 to 50 Fire Damage if you've Killed Recently
Enchantment Fire Damage 3	Eternal Labyrinth	Adds 45 to 68 Fire Damage if you've Killed Recently
Enchantment Attack and Cast Speed 1	Cruel Labyrinth	8% increased Attack and Cast Speed if you've Killed Recently
Enchantment Attack and Cast Speed 2	Merciless Labyrinth	12% increased Attack and Cast Speed if you've Killed Recently
Enchantment Attack and Cast Speed 3	Eternal Labyrinth	16% increased Attack and Cast Speed if you've Killed Recently
Enchantment Status Ailments 1	Cruel Labyrinth	6% chance to Freeze, Shock and Ignite if you haven't Crit Recently
Enchantment Status Ailments 2	Merciless Labyrinth	8% chance to Freeze, Shock and Ignite if you haven't Crit Recently
Enchantment Status Ailments 3	Eternal Labyrinth	10% chance to Freeze, Shock and Ignite if you haven't Crit Recently
Enchantment Cold Damage 1	Cruel Labyrinth	Adds 16 to 24 Cold Damage if you've been Hit Recently
Enchantment Cold Damage 2	Merciless Labyrinth	Adds 33 to 50 Cold Damage if you've been Hit Recently
Enchantment Cold Damage 3	Eternal Labyrinth	Adds 45 to 68 Cold Damage if you've been Hit Recently
Enchantment Critical Strike Chance 1	Cruel Labyrinth	60% increased Critical Strike Chance if you haven't Crit Recently
Enchantment Critical Strike Chance 2	Merciless Labyrinth	90% increased Critical Strike Chance if you haven't Crit Recently
Enchantment Critical Strike Chance 3	Eternal Labyrinth	120% increased Critical Strike Chance if you haven't Crit Recently
Enchantment Attack Dodge 1	Cruel Labyrinth	6% Chance to Dodge Attack Hits if you've taken a Critical Strike Recently
Enchantment Attack Dodge 2	Merciless Labyrinth	8% Chance to Dodge Attack Hits if you've taken a Critical Strike Recently
Enchantment Attack Dodge 3	Eternal Labyrinth	10% Chance to Dodge Attack Hits if you've taken a Critical Strike Recently
Enchantment Elemental Penetration 1	Cruel Labyrinth	Damage Penetrates 6% of Enemy Elemental Resistances if you haven't Killed Recently
Enchantment Elemental Penetration 2	Merciless Labyrinth	Damage Penetrates 8% of Enemy Elemental Resistances if you haven't Killed Recently
Enchantment Elemental Penetration 3	Eternal Labyrinth	Damage Penetrates 10% of Enemy Elemental Resistances if you haven't Killed Recently
Enchantment Leech 1	Cruel Labyrinth	0.4% of Damage Leeched as Life if you've Killed Recently
Enchantment Leech 2	Merciless Labyrinth	0.5% of Damage Leeched as Life if you've Killed Recently
Enchantment Leech 3	Eternal Labyrinth	0.6% of Damage Leeched as Life if you've Killed Recently
Enchantment Regeneration 1	Cruel Labyrinth	Regenerate 1% of Life per second if you were Hit Recently
Enchantment Regeneration 2	Merciless Labyrinth	Regenerate 1.5% of Life per second if you were Hit Recently
Enchantment Regeneration 3	Eternal Labyrinth	Regenerate 2% of Life per second if you were Hit Recently
Enchantment Lightning Damage 1	Cruel Labyrinth	Adds 1 to 56 Lightning Damage if you haven't Killed Recently
Enchantment Lightning Damage 2	Merciless Labyrinth	Adds 1 to 120 Lightning Damage if you haven't Killed Recently
Enchantment Lightning Damage 3	Eternal Labyrinth	Adds 1 to 160 Lightning Damage if you haven't Killed Recently
Enchantment Mana Cost 1	Cruel Labyrinth	10% reduced Mana Cost of Skills if you've been Hit Recently
Enchantment Mana Cost 2	Merciless Labyrinth	14% reduced Mana Cost of Skills if you've been Hit Recently
Enchantment Mana Cost 3	Eternal Labyrinth	18% reduced Mana Cost of Skills if you've been Hit Recently
Enchantment Mana Regeneration 1	Cruel Labyrinth	30% increased Mana Regeneration Rate if you've cast a Spell Recently
Enchantment Mana Regeneration 2	Merciless Labyrinth	50% increased Mana Regeneration Rate if you've cast a Spell Recently
Enchantment Mana Regeneration 3	Eternal Labyrinth	70% increased Mana Regeneration Rate if you've cast a Spell Recently
Enchantment Movement Speed 1	Cruel Labyrinth	6% increased Movement Speed if you haven't been Hit Recently
Enchantment Movement Speed 2	Merciless Labyrinth	8% increased Movement Speed if you haven't been Hit Recently
Enchantment Movement Speed 3	Eternal Labyrinth	10% increased Movement Speed if you haven't been Hit Recently
Enchantment Spell Dodge 1	Cruel Labyrinth	5% chance to Dodge Spell Hits if you've taken Spell Damage Recently
Enchantment Spell Dodge 2	Merciless Labyrinth	6% chance to Dodge Spell Hits if you've taken Spell Damage Recently
Enchantment Spell Dodge 3	Eternal Labyrinth	8% chance to Dodge Spell Hits if you've taken Spell Damage Recently
Enchantment Stun Avoidance 1	Cruel Labyrinth	50% chance to Avoid being Stunned if you've Killed Recently
Enchantment Stun Avoidance 2	Merciless Labyrinth	65% chance to Avoid being Stunned if you've Killed Recently
Enchantment Stun Avoidance 3	Eternal Labyrinth	80% chance to Avoid being Stunned if you've Killed Recently
Armageddon Brand Attached Target Fire Penetration 1	Merciless Labyrinth	Armageddon Brand Damage Penetrates 8% of Branded Enemy's Fire Resistance
Armageddon Brand Attached Target Fire Penetration 2	Eternal Labyrinth	Armageddon Brand Damage Penetrates 12% of Branded Enemy's Fire Resistance
Armageddon Brand Repeat Frequency 1	Merciless Labyrinth	Armageddon Brand has 8% increased Activation Frequency
Armageddon Brand Repeat Frequency 2	Eternal Labyrinth	Armageddon Brand has 12% increased Activation Frequency
Enchantment Ancestral Protector Attack Speed 1	Merciless Labyrinth	Ancestral Protector Totem grants 12% increased Attack Speed while Active
Enchantment Ancestral Protector Attack Speed 2	Eternal Labyrinth	Ancestral Protector Totem grants 18% increased Attack Speed while Active
Enchantment Ancestral Protector Damage 1	Merciless Labyrinth	Ancestral Protector Totem deals 25% increased Damage
Enchantment Ancestral Protector Damage 2	Eternal Labyrinth	Ancestral Protector Totem deals 40% increased Damage
Enchantment Ancestral Protector Resistances 1	Merciless Labyrinth	+24% to Ancestral Protector Totem Elemental Resistances
Enchantment Ancestral Protector Resistances 2	Eternal Labyrinth	+36% to Ancestral Protector Totem Elemental Resistances
Enchantment Ancestral Protector Placement Speed 1	Merciless Labyrinth	12% increased Ancestral Protector Totem Placement Speed
Enchantment Ancestral Protector Placement Speed 2	Eternal Labyrinth	18% increased Ancestral Protector Totem Placement Speed
Enchantment Ancestral Warchief Damage 1	Merciless Labyrinth	25% increased Ancestral Warchief Totem Damage
Enchantment Ancestral Warchief Damage 2	Eternal Labyrinth	40% increased Ancestral Warchief Totem Damage
Enchantment Ancestor Warchief Melee Damage 1	Merciless Labyrinth	Ancestral Warchief Totem grants 20% increased Melee Damage while Active
Enchantment Ancestor Warchief Melee Damage 2	Eternal Labyrinth	Ancestral Warchief Totem grants 30% increased Melee Damage while Active
Enchantment Ancestor Warchief Area Of Effect 1	Merciless Labyrinth	16% increased Ancestral Warchief Totem Area of Effect
Enchantment Ancestor Warchief Area Of Effect 2	Eternal Labyrinth	24% increased Ancestral Warchief Totem Area of Effect
Enchantment Ancestral Cry Exerted Attack Damage 1	Merciless Labyrinth	Attacks Exerted by Ancestral Cry deal 35% increased Damage
Enchantment Ancestral Cry Exerted Attack Damage 2	Eternal Labyrinth	Attacks Exerted by Ancestral Cry deal 50% increased Damage
Enchantment Ancestral Cry Minimum Power 1	Eternal Labyrinth	Ancestral Cry has a minimum of 10 Power
Enchantment Anger Reservation 1	Merciless Labyrinth	Anger has 10% reduced Mana Reservation
Enchantment Anger Reservation 2	Eternal Labyrinth	Anger has 15% reduced Mana Reservation
Enchantment Animate Guardian Damage 1	Merciless Labyrinth	Animated Guardians deal 25% increased Damage
Enchantment Animate Guardian Damage 2	Eternal Labyrinth	Animated Guardians deal 40% increased Damage
Enchantment Animate Guardian Elemental Resistances 1	Merciless Labyrinth	+24% to Animated Guardian Elemental Resistances
Enchantment Animate Guardian Elemental Resistances 2	Eternal Labyrinth	+36% to Animated Guardian Elemental Resistances
Enchantment Animate Weapon Chance To Create Additional Copy 1	Merciless Labyrinth	16% chance to create an additional Animate Weapon copy
Enchantment Animate Weapon Chance To Create Additional Copy 2	Eternal Labyrinth	24% chance to create an additional Animate Weapon copy
Enchantment Animate Weapon Damage 1	Merciless Labyrinth	Animated Weapons deal 25% increased Damage
Enchantment Animate Weapon Damage 2	Eternal Labyrinth	Animated Weapons deal 40% increased Damage
Enchantment Animate Weapon Duration 1	Merciless Labyrinth	20% increased Animate Weapon Duration
Enchantment Animate Weapon Duration 2	Eternal Labyrinth	30% increased Animate Weapon Duration
Enchantment Arcane Cloak Additional Mana Spent 1	Merciless Labyrinth	Arcane Cloak Spends an additional 10% of current Mana
Enchantment Arcane Cloak Additional Mana Spent 2	Eternal Labyrinth	Arcane Cloak Spends an additional 15% of current Mana
Enchantment Arcane Cloak Grants Life Regeneration 1	Eternal Labyrinth	Arcane Cloak grants Life Regeneration equal to 15% of Mana Spent per Second
Enchantment Arcanist Brand Cast Speed 1	Merciless Labyrinth	Arcanist Brand has 8% increased Cast Speed
Enchantment Arcanist Brand Cast Speed 2	Eternal Labyrinth	Arcanist Brand has 12% increased Cast Speed
Enchantment Arcanist Brand Unnerve 1	Eternal Labyrinth	Spells Triggered by Arcanist Brand Unnerve enemies on Hit for 4 seconds
Enchantment Arc Damage 1	Merciless Labyrinth	25% increased Arc Damage
Enchantment Arc Damage 2	Eternal Labyrinth	40% increased Arc Damage
Enchantment Arc Damage Per Chain 1	Merciless Labyrinth	Arc deals 8% increased Damage for each time it has Chained
Enchantment Arc Damage Per Chain 2	Eternal Labyrinth	Arc deals 12% increased Damage for each time it has Chained
Enchantment Arc Num Of Additional Projectiles In Chain 1	Eternal Labyrinth	Arc Chains an additional time
Enchantment Arc Shock Chance 1	Merciless Labyrinth	Arc has +20% chance to Shock
Enchantment Arc Shock Chance 2	Eternal Labyrinth	Arc has +30% chance to Shock
Enchantment Arctic Armour Buff Effect 1	Merciless Labyrinth	24% increased Arctic Armour Buff Effect
Enchantment Arctic Armour Buff Effect 2	Eternal Labyrinth	36% increased Arctic Armour Buff Effect
Enchantment Arctic Armour Mana Reservation 1	Merciless Labyrinth	Arctic Armour has 20% reduced Mana Reservation
Enchantment Arctic Armour Mana Reservation 2	Eternal Labyrinth	Arctic Armour has 30% reduced Mana Reservation
Enchantment Creeping Frost Chilling Area Movement Velocity 1	Eternal Labyrinth	Creeping Frost's Chilling Area has 38% increased Movement Speed
Enchantment Creeping Frost Damage 1	Merciless Labyrinth	25% increased Creeping Frost Damage
Enchantment Creeping Frost Damage 2	Eternal Labyrinth	40% increased Creeping Frost Damage
Enchantment Creeping Frost Duration 1	Merciless Labyrinth	24% increased Creeping Frost Duration
Enchantment Creeping Frost Duration 2	Eternal Labyrinth	36% increased Creeping Frost Duration
Enchantment Creeping Frost Area Of Effect 1	Merciless Labyrinth	16% increased Creeping Frost Area of Effect
Enchantment Creeping Frost Area Of Effect 2	Eternal Labyrinth	24% increased Creeping Frost Area of Effect
Enchantment Armageddon Brand Damage 1	Merciless Labyrinth	Armageddon Brand deals 25% increased Damage
Enchantment Armageddon Brand Damage 2	Eternal Labyrinth	Armageddon Brand deals 40% increased Damage
Enchantment Artillery Ballista Cross Pattern 1	Eternal Labyrinth	Artillery Ballista Projectiles fall in two perpendicular lines instead
Enchantment Artillery Ballista Additional Arrows 1	Merciless Labyrinth	Artillery Ballista fires an additional Arrow
Enchantment Artillery Ballista Additional Arrows 2	Eternal Labyrinth	Artillery Ballista fires 2 additional Arrows
Enchantment Artillery Ballista Fire Penetration 1	Merciless Labyrinth	Artillery Ballista Damage Penetrates 6% Fire Resistance
Enchantment Artillery Ballista Fire Penetration 2	Eternal Labyrinth	Artillery Ballista Damage Penetrates 10% Fire Resistance
Enchantment Assassins Mark Curse Effect 1	Merciless Labyrinth	20% increased Assassin's Mark Curse Effect
Enchantment Assassins Mark Curse Effect 2	Eternal Labyrinth	30% increased Assassin's Mark Curse Effect
Enchantment Assassins Mark Duration 1	Merciless Labyrinth	30% increased Assassin's Mark Duration
Enchantment Assassins Mark Duration 2	Eternal Labyrinth	45% increased Assassin's Mark Duration
Enchantment Ball Lightning Additional Projectiles 1	Eternal Labyrinth	Ball Lightning fires an additional Projectile
Enchantment Ball Lightning Damage 1	Merciless Labyrinth	25% increased Ball Lightning Damage
Enchantment Ball Lightning Damage 2	Eternal Labyrinth	40% increased Ball Lightning Damage
Enchantment Ball Lightning Area Of Effect 1	Merciless Labyrinth	16% increased Ball Lightning Area of Effect
Enchantment Ball Lightning Area Of Effect 2	Eternal Labyrinth	24% increased Ball Lightning Area of Effect
Enchantment Bane Area Of Effect 1	Merciless Labyrinth	Bane has 16% increased Area of Effect
Enchantment Bane Area Of Effect 2	Eternal Labyrinth	Bane has 24% increased Area of Effect
Enchantment Bane Damage 1	Merciless Labyrinth	Bane deals 25% increased Damage
Enchantment Bane Damage 2	Eternal Labyrinth	Bane deals 40% increased Damage
Enchantment Bane Linked Curse Effect 1	Merciless Labyrinth	10% increased Effect of Curses applied by Bane
Enchantment Bane Linked Curse Effect 2	Eternal Labyrinth	15% increased Effect of Curses applied by Bane
Enchantment Barrage Attack Speed 1	Merciless Labyrinth	10% increased Barrage Attack Speed
Enchantment Barrage Attack Speed 2	Eternal Labyrinth	15% increased Barrage Attack Speed
Enchantment Barrage Damage 1	Merciless Labyrinth	25% increased Barrage Damage
Enchantment Barrage Damage 2	Eternal Labyrinth	40% increased Barrage Damage
Enchantment Barrage Num Of Additional Projectiles 1	Eternal Labyrinth	Barrage fires an additional Projectile
Enchantment Bear Trap Cooldown Speed 1	Merciless Labyrinth	Bear Trap has 10% increased Cooldown Recovery Rate
Enchantment Bear Trap Cooldown Speed 2	Eternal Labyrinth	Bear Trap has 15% increased Cooldown Recovery Rate
Enchantment Bear Trap Damage 1	Merciless Labyrinth	25% increased Bear Trap Damage
Enchantment Bear Trap Damage 2	Eternal Labyrinth	40% increased Bear Trap Damage
Enchantment Bear Trap Damage Taken 1	Merciless Labyrinth	Enemies affected by Bear Trap take 5% increased Damage from Trap or Mine Hits
Enchantment Bear Trap Damage Taken 2	Eternal Labyrinth	Enemies affected by Bear Trap take 10% increased Damage from Trap or Mine Hits
Enchantment Berserk Effect 1	Merciless Labyrinth	Berserk has 20% increased Buff Effect
Enchantment Berserk Effect 2	Eternal Labyrinth	Berserk has 30% increased Buff Effect
Enchantment Berserk Rage Loss 1	Merciless Labyrinth	Berserk has 25% reduced Rage loss per second
Enchantment Berserk Rage Loss 2	Eternal Labyrinth	Berserk has 40% reduced Rage loss per second
Enchantment Blade Blast Area of Effect 1	Merciless Labyrinth	Blade Blast has 16% increased Area of Effect
Enchantment Blade Blast Area of Effect 2	Eternal Labyrinth	Blade Blast has 24% increased Area of Effect
Enchantment Blade Blast Damage 1	Merciless Labyrinth	Blade Blast deals 25% increased Damage
Enchantment Blade Blast Damage 2	Eternal Labyrinth	Blade Blast deals 40% increased Damage
Enchantment Blade Blast Detonation Area 1	Merciless Labyrinth	Blade Blast detonates other Lingering Blades within an 50% increased Area
Enchantment Blade Blast Detonation Area 2	Eternal Labyrinth	Blade Blast detonates other Lingering Blades within an 75% increased Area
Enchantment Bladefall Additional Volley	Eternal Labyrinth	Bladefall has an additional Volley
Enchantment Bladefall Critical Strike Chance 1	Merciless Labyrinth	60% increased Bladefall Critical Strike Chance
Enchantment Bladefall Critical Strike Chance 2	Eternal Labyrinth	90% increased Bladefall Critical Strike Chance
Enchantment Bladefall Damage 1	Merciless Labyrinth	25% increased Bladefall Damage
Enchantment Bladefall Damage 2	Eternal Labyrinth	40% increased Bladefall Damage
Enchantment Bladefall Area Of Effect 1	Merciless Labyrinth	16% increased Bladefall Area of Effect
Enchantment Bladefall Area Of Effect 2	Eternal Labyrinth	24% increased Bladefall Area of Effect
Enchantment Bladestorm Damage 1	Merciless Labyrinth	Bladestorm deals 25% increased Damage
Enchantment Bladestorm Damage 2	Eternal Labyrinth	Bladestorm deals 40% increased Damage
Enchantment Bladestorm Maximum Number Of Storms Allowed 1	Eternal Labyrinth	+1 to maximum number of Bladestorms
Enchantment Bladestorm Sandstorm Speed 1	Merciless Labyrinth	Sand Bladestorms move with 50% increased speed
Enchantment Bladestorm Sandstorm Speed 2	Eternal Labyrinth	Sand Bladestorms move with 75% increased speed
Enchantment Blade Vortex Crit Multi Per Blade 1	Merciless Labyrinth	Blade Vortex has +2% to Critical Strike Multiplier for each blade
Enchantment Blade Vortex Crit Multi Per Blade 2	Eternal Labyrinth	Blade Vortex has +3% to Critical Strike Multiplier for each blade
Enchantment Blade Vortex Damage 1	Merciless Labyrinth	25% increased Blade Vortex Spell Damage
Enchantment Blade Vortex Damage 2	Eternal Labyrinth	40% increased Blade Vortex Spell Damage
Enchantment Blade Vortex Duration 1	Merciless Labyrinth	20% increased Blade Vortex Duration
Enchantment Blade Vortex Duration 2	Eternal Labyrinth	30% increased Blade Vortex Duration
Enchantment Blade Vortex Area Of Effect 1	Merciless Labyrinth	16% increased Blade Vortex Area of Effect
Enchantment Blade Vortex Area Of Effect 2	Eternal Labyrinth	24% increased Blade Vortex Area of Effect
Enchantment Blast Rain Additional Blast 2	Eternal Labyrinth	Blast Rain fires an additional Arrow
Enchantment Blast Rain Damage 1	Merciless Labyrinth	Blast Rain deals 25% increased Damage
Enchantment Blast Rain Damage 2	Eternal Labyrinth	Blast Rain deals 40% increased Damage
Enchantment Blast Rain Area Of Effect 1	Merciless Labyrinth	Blast Rain has 16% increased Area of Effect
Enchantment Blast Rain Area Of Effect 2	Eternal Labyrinth	Blast Rain has 24% increased Area of Effect
Enchantment Blazing Salvo Damage 1	Merciless Labyrinth	Blazing Salvo deals 25% increased Damage
Enchantment Blazing Salvo Damage 2	Eternal Labyrinth	Blazing Salvo deals 40% increased Damage
Enchantment Blazing Salvo Num of Additional Projectiles 1	Eternal Labyrinth	Blazing Salvo fires an additional Projectile
Enchantment Blazing Salvo Spread Area 1	Merciless Labyrinth	Blazing Salvo Projectiles land in a 20% increased Area
Enchantment Blazing Salvo Spread Area 2	Eternal Labyrinth	Blazing Salvo Projectiles land in a 30% increased Area
Enchantment Blight Damage 1	Merciless Labyrinth	25% increased Blight Damage
Enchantment Blight Damage 2	Eternal Labyrinth	40% increased Blight Damage
Enchantment Blight Area Of Effect 1	Merciless Labyrinth	16% increased Blight Area of Effect
Enchantment Blight Area Of Effect 2	Eternal Labyrinth	24% increased Blight Area of Effect
Enchantment Blight Secondary Skill Duration 1	Merciless Labyrinth	Blight has 20% increased Hinder Duration
Enchantment Blight Secondary Skill Duration 2	Eternal Labyrinth	Blight has 30% increased Hinder Duration
Enchantment Blink Arrow Attack Speed 1	Merciless Labyrinth	Blink Arrow and Blink Arrow Clones have 10% increased Attack Speed
Enchantment Blink Arrow Attack Speed 2	Eternal Labyrinth	Blink Arrow and Blink Arrow Clones have 15% increased Attack Speed
Enchantment Blink Arrow Cooldown Speed 1	Merciless Labyrinth	Blink Arrow has 20% increased Cooldown Recovery Rate
Enchantment Blink Arrow Cooldown Speed 2	Eternal Labyrinth	Blink Arrow has 30% increased Cooldown Recovery Rate
Enchantment Blink Arrow Damage 1	Merciless Labyrinth	Blink Arrow and Blink Arrow Clones have 25% increased Damage
Enchantment Blink Arrow Damage 2	Eternal Labyrinth	Blink Arrow and Blink Arrow Clones have 40% increased Damage
Enchantment Blood and Sand Buff Effect 1	Merciless Labyrinth	Blood and Sand has 25% increased Buff Effect
Enchantment Blood and Sand Buff Effect 2	Eternal Labyrinth	Blood and Sand has 40% increased Buff Effect
Enchantment Blood Rage Attack Speed 1	Merciless Labyrinth	Blood Rage grants additional 8% increased Attack Speed
Enchantment Blood Rage Attack Speed 2	Eternal Labyrinth	Blood Rage grants additional 12% increased Attack Speed
Enchantment Blood Rage Frenzy On Kill 1	Merciless Labyrinth	Blood Rage grants additional 20% chance to gain a Frenzy Charge on Kill
Enchantment Blood Rage Frenzy On Kill 2	Eternal Labyrinth	Blood Rage grants additional 30% chance to gain a Frenzy Charge on Kill
Enchantment Body Swap Cast Speed 1	Merciless Labyrinth	8% increased Bodyswap Cast Speed
Enchantment Body Swap Cast Speed 2	Eternal Labyrinth	12% increased Bodyswap Cast Speed
Enchantment Body Swap Damage 1	Merciless Labyrinth	25% increased Bodyswap Damage
Enchantment Body Swap Damage 2	Eternal Labyrinth	40% increased Bodyswap Damage
Enchantment Unearth Cast Speed 1	Merciless Labyrinth	8% increased Unearth Cast Speed
Enchantment Unearth Cast Speed 2	Eternal Labyrinth	12% increased Unearth Cast Speed
Enchantment Unearth Corpse Level 1	Merciless Labyrinth	Unearth Spawns corpses with +3 Level
Enchantment Unearth Corpse Level 2	Eternal Labyrinth	Unearth Spawns corpses with +5 Level
Enchantment Unearth Damage 1	Merciless Labyrinth	25% increased Unearth Damage
Enchantment Unearth Damage 2	Eternal Labyrinth	40% increased Unearth Damage
Enchantment Bone Offering Block Chance 1	Merciless Labyrinth	Bone Offering grants an additional +6% Chance to Block Attack Damage
Enchantment Bone Offering Block Chance 2	Eternal Labyrinth	Bone Offering grants an additional +9% Chance to Block Attack Damage
Enchantment Bone Offering Duration 1	Merciless Labyrinth	30% increased Bone Offering Duration
Enchantment Bone Offering Duration 2	Eternal Labyrinth	45% increased Bone Offering Duration
Enchantment Burning Arrow Damage 1	Merciless Labyrinth	25% increased Burning Arrow Damage
Enchantment Burning Arrow Damage 2	Eternal Labyrinth	40% increased Burning Arrow Damage
Enchantment Burning Arrow Debuff Effect 1	Merciless Labyrinth	Burning Arrow has 16% increased Debuff Effect
Enchantment Burning Arrow Debuff Effect 2	Eternal Labyrinth	Burning Arrow has 24% increased Debuff Effect
Enchantment Burning Arrow Ignite Chance 1	Merciless Labyrinth	Burning Arrow has +20% chance to Ignite
Enchantment Burning Arrow Ignite Chance 2	Eternal Labyrinth	Burning Arrow has +30% chance to Ignite
Enchantment Burning Arrow Physical Damage Percent To Add As Fire Damage 1	Merciless Labyrinth	10% of Burning Arrow Physical Damage gained as Extra Fire Damage
Enchantment Burning Arrow Physical Damage Percent To Add As Fire Damage 2	Eternal Labyrinth	15% of Burning Arrow Physical Damage gained as Extra Fire Damage
Enchantment Summon Carrion Golem Damage 1	Merciless Labyrinth	Summoned Carrion Golems deal 25% increased Damage
Enchantment Summon Carrion Golem Damage 2	Eternal Labyrinth	Summoned Carrion Golems deal 40% increased Damage
Enchantment Summon Carrion Golem Elemental Resistances 1	Merciless Labyrinth	Summoned Carrion Golems have +24% to all Elemental Resistances
Enchantment Summon Carrion Golem Elemental Resistances 2	Eternal Labyrinth	Summoned Carrion Golems have +36% to all Elemental Resistances
Enchantment Summon Carrion Golem Granted Buff Effect 1	Merciless Labyrinth	100% increased Effect of the Buff granted by your Carrion Golems
Enchantment Summon Carrion Golem Granted Buff Effect 2	Eternal Labyrinth	150% increased Effect of the Buff granted by your Carrion Golems
Enchantment Caustic Arrow Damage 1	Merciless Labyrinth	25% increased Caustic Arrow Damage
Enchantment Caustic Arrow Damage 2	Eternal Labyrinth	40% increased Caustic Arrow Damage
Enchantment Caustic Arrow Duration 1	Merciless Labyrinth	20% increased Caustic Arrow Duration
Enchantment Caustic Arrow Duration 2	Eternal Labyrinth	30% increased Caustic Arrow Duration
Enchantment Caustic Arrow Area Of Effect 1	Merciless Labyrinth	16% increased Caustic Arrow Area of Effect
Enchantment Caustic Arrow Area Of Effect 2	Eternal Labyrinth	24% increased Caustic Arrow Area of Effect
Enchantment Caustic Arrow Wither On Hit 1	Merciless Labyrinth	Caustic Arrow has 14% chance to inflict Withered on Hit for 2 seconds base Duration
Enchantment Caustic Arrow Wither On Hit 2	Eternal Labyrinth	Caustic Arrow has 20% chance to inflict Withered on Hit for 2 seconds base Duration
Enchantment Chain Hook Cone Radius Per 12 Rage 1	Eternal Labyrinth	Chain Hook has +1 Radius per 12 Rage
Enchantment Chain Hook Damage 1	Merciless Labyrinth	Chain Hook deals 25% increased Damage
Enchantment Chain Hook Damage 2	Eternal Labyrinth	Chain Hook deals 40% increased Damage
Enchantment Chain Hook Gain Rage On Hit Chance 1	Merciless Labyrinth	Chain Hook has a 25% chance to grant +1 Rage if it Hits Enemies
Enchantment Chain Hook Gain Rage On Hit Chance 2	Eternal Labyrinth	Chain Hook has a 40% chance to grant +1 Rage if it Hits Enemies
Enchantment Chaos Golem Elemental Resistances 1	Merciless Labyrinth	+24% to Chaos Golem Elemental Resistances
Enchantment Chaos Golem Elemental Resistances 2	Eternal Labyrinth	+36% to Chaos Golem Elemental Resistances
Enchantment Chaos Golem Percent Additional Physical Damage Reduction 1	Merciless Labyrinth	75% increased Effect of the Buff granted by your Chaos Golems
Enchantment Chaos Golem Percent Additional Physical Damage Reduction 2	Eternal Labyrinth	100% increased Effect of the Buff granted by your Chaos Golems
Enchantment Blade Flurry Damage 1	Merciless Labyrinth	25% increased Blade Flurry Damage
Enchantment Blade Flurry Damage 2	Eternal Labyrinth	40% increased Blade Flurry Damage
Enchantment Blade Flurry Dodge Per Stack 1	Merciless Labyrinth	6% chance to Dodge Attack Hits while at maximum Blade Flurry stages
Enchantment Blade Flurry Dodge Per Stack 2	Eternal Labyrinth	9% chance to Dodge Attack Hits while at maximum Blade Flurry stages
Enchantment Blade Flurry Area Of Effect 1	Merciless Labyrinth	16% increased Blade Flurry Area of Effect
Enchantment Blade Flurry Area Of Effect 2	Eternal Labyrinth	24% increased Blade Flurry Area of Effect
Enchantment Charged Dash Damage 1	Merciless Labyrinth	25% increased Charged Dash Damage
Enchantment Charged Dash Damage 2	Eternal Labyrinth	40% increased Charged Dash Damage
Enchantment Charged Dash Dodge When Finished Channelling 1	Merciless Labyrinth	4% chance to Dodge Attack Hits if you have finished Channelling Charged Dash Recently
Enchantment Charged Dash Dodge When Finished Channelling 2	Eternal Labyrinth	6% chance to Dodge Attack Hits if you have finished Channelling Charged Dash Recently
Enchantment Charged Dash Movement Speed 1	Merciless Labyrinth	Charged Dash has 10% more Movement Speed
Enchantment Charged Dash Movement Speed 2	Eternal Labyrinth	Charged Dash has 15% more Movement Speed
Enchantment Charged Dash Radius Final Explosion 1	Merciless Labyrinth	Charged Dash has +4 to Radius of each Wave's last damage Area
Enchantment Charged Dash Radius Final Explosion 2	Eternal Labyrinth	Charged Dash has +6 to Radius of each Wave's last damage Area
Enchantment Clarity Mana Reservation 1	Merciless Labyrinth	Clarity has 20% reduced Mana Reservation
Enchantment Clarity Mana Reservation 2	Eternal Labyrinth	Clarity has 30% reduced Mana Reservation
Enchantment Cleave Attack Speed 1	Merciless Labyrinth	10% increased Cleave Attack Speed
Enchantment Cleave Attack Speed 2	Eternal Labyrinth	15% increased Cleave Attack Speed
Enchantment Cleave Damage 1	Merciless Labyrinth	25% increased Cleave Damage
Enchantment Cleave Damage 2	Eternal Labyrinth	40% increased Cleave Damage
Enchantment Cleave Area Of Effect 1	Merciless Labyrinth	16% increased Cleave Area of Effect
Enchantment Cleave Area Of Effect 2	Eternal Labyrinth	24% increased Cleave Area of Effect
Enchantment Cobra Lash Damage 1	Merciless Labyrinth	Cobra Lash deals 25% increased Damage
Enchantment Cobra Lash Damage 2	Eternal Labyrinth	Cobra Lash deals 40% increased Damage
Enchantment Cobra Lash Number Of Additional Chains 1	Merciless Labyrinth	Cobra Lash Chains 2 additional times
Enchantment Cobra Lash Number Of Additional Chains 2	Eternal Labyrinth	Cobra Lash Chains 3 additional times
Enchantment Cobra Lash Projectile Speed 1	Merciless Labyrinth	Cobra Lash has 20% increased Projectile Speed
Enchantment Cobra Lash Projectile Speed 2	Eternal Labyrinth	Cobra Lash has 30% increased Projectile Speed
Enchantment Icicle Mine Critical Multiplier 1	Merciless Labyrinth	Icicle Mine has +20% to Critical Strike Multiplier
Enchantment Icicle Mine Critical Multiplier 2	Eternal Labyrinth	Icicle Mine has +30% to Critical Strike Multiplier
Enchantment Icicle Mine Damage 1	Merciless Labyrinth	Icicle Mine deals 25% increased Damage
Enchantment Icicle Mine Damage 2	Eternal Labyrinth	Icicle Mine deals 40% increased Damage
Enchantment Icicle Mine Throwing Speed 1	Merciless Labyrinth	Icicle Mine has 10% increased Throwing Speed
Enchantment Icicle MineThrowing Speed 2	Eternal Labyrinth	Icicle Mine has 15% increased Throwing Speed
Enchantment Cold Snap Cooldown Speed 1	Merciless Labyrinth	Cold Snap has 20% increased Cooldown Recovery Rate
Enchantment Cold Snap Cooldown Speed 2	Eternal Labyrinth	Cold Snap has 30% increased Cooldown Recovery Rate
Enchantment Cold Snap Damage 1	Merciless Labyrinth	25% increased Cold Snap Damage
Enchantment Cold Snap Damage 2	Eternal Labyrinth	40% increased Cold Snap Damage
Enchantment Cold Snap Area Of Effect 1	Merciless Labyrinth	16% increased Cold Snap Area of Effect
Enchantment Cold Snap Area Of Effect 2	Eternal Labyrinth	24% increased Cold Snap Area of Effect
Enchantment Conductivity Curse Effect 1	Merciless Labyrinth	20% increased Conductivity Curse Effect
Enchantment Conductivity Curse Effect 2	Eternal Labyrinth	30% increased Conductivity Curse Effect
Enchantment Conductivity Duration 1	Merciless Labyrinth	30% increased Conductivity Duration
Enchantment Conductivity Duration 2	Eternal Labyrinth	45% increased Conductivity Duration
Enchantment Consecrated Path Damage 1	Merciless Labyrinth	Consecrated Path deals 25% increased Damage
Enchantment Consecrated Path Damage 2	Eternal Labyrinth	Consecrated Path deals 40% increased Damage
Enchantment Consecrated Path Area Of Effect 1	Merciless Labyrinth	Consecrated Path has 16% increased Area of Effect
Enchantment Consecrated Path Area Of Effect 2	Eternal Labyrinth	Consecrated Path has 24% increased Area of Effect
Enchantment Consecrated Path Range 1	Merciless Labyrinth	Consecrated Path has 10% increased teleport range
Enchantment Consecrated Path Range 2	Eternal Labyrinth	Consecrated Path has 15% increased teleport range
Enchantment Contagion Damage 1	Merciless Labyrinth	25% increased Contagion Damage
Enchantment Contagion Damage 2	Eternal Labyrinth	40% increased Contagion Damage
Enchantment Contagion Duration 1	Merciless Labyrinth	20% increased Contagion Duration
Enchantment Contagion Duration 2	Eternal Labyrinth	30% increased Contagion Duration
Enchantment Contagion Radius 1	Merciless Labyrinth	16% increased Contagion Area of Effect
Enchantment Contagion Radius 2	Eternal Labyrinth	24% increased Contagion Area of Effect
Enchantment Conversion Trap Cooldown Speed 1	Merciless Labyrinth	Conversion Trap 20% increased Cooldown Recovery Rate
Enchantment Conversion Trap Cooldown Speed 2	Eternal Labyrinth	Conversion Trap 30% increased Cooldown Recovery Rate
Enchantment Conversion Trap Damage 1	Merciless Labyrinth	Converted Enemies have 25% increased Damage
Enchantment Conversion Trap Damage 2	Eternal Labyrinth	Converted Enemies have 40% increased Damage
Enchantment Convocation Cooldown Speed 1	Merciless Labyrinth	Convocation has 20% increased Cooldown Recovery Rate
Enchantment Convocation Cooldown Speed 2	Eternal Labyrinth	Convocation has 30% increased Cooldown Recovery Rate
Enchantment Convocation Life Regeneration 1	Merciless Labyrinth	24% increased Convocation Buff Effect
Enchantment Convocation Life Regeneration 2	Eternal Labyrinth	36% increased Convocation Buff Effect
Enchantment Cremation Cast Speed 1	Merciless Labyrinth	8% increased Cremation Cast Speed
Enchantment Cremation Cast Speed 2	Eternal Labyrinth	12% increased Cremation Cast Speed
Enchantment Cremation Damage 1	Merciless Labyrinth	25% increased Cremation Damage
Enchantment Cremation Damage 2	Eternal Labyrinth	40% increased Cremation Damage
Enchantment Cremation Maximum Geysers 1	Eternal Labyrinth	Cremation can have up to 1 additional Geyser at a time
Enchantment Crackling Lance Cast Speed 1	Merciless Labyrinth	Crackling Lance has 8% increased Cast Speed
Enchantment Crackling Lance Cast Speed 2	Eternal Labyrinth	Crackling Lance has 16% increased Cast Speed
Enchantment Crackling Lance Damage 1	Merciless Labyrinth	Crackling Lance deals 25% increased Damage
Enchantment Crackling Lance Damage 2	Eternal Labyrinth	Crackling Lance deals 40% increased Damage
Enchantment Crackling Lance Beam Angle 1	Merciless Labyrinth	Crackling Lance has 24% increased branching angle
Enchantment Crackling Lance Beam Angle 2	Eternal Labyrinth	Crackling Lance has 36% increased branching angle
Enchantment Cyclone Attack Speed 1	Merciless Labyrinth	10% increased Cyclone Attack Speed
Enchantment Cyclone Attack Speed 2	Eternal Labyrinth	15% increased Cyclone Attack Speed
Enchantment Cyclone Damage 1	Merciless Labyrinth	25% increased Cyclone Damage
Enchantment Cyclone Damage 2	Eternal Labyrinth	40% increased Cyclone Damage
Enchantment Dash Cooldown Count 1	Merciless Labyrinth	Dash has +1 Cooldown Use
Enchantment Dash Cooldown Count 2	Eternal Labyrinth	Dash has +2 Cooldown Uses
Enchantment Dash Travel Distance 1	Merciless Labyrinth	Dash travels 65% increased distance
Enchantment Dash Travel Distance 2	Eternal Labyrinth	Dash travels 100% increased distance
Enchantment Decoy Totem Life 1	Merciless Labyrinth	40% increased Decoy Totem Life
Enchantment Decoy Totem Life 2	Eternal Labyrinth	60% increased Decoy Totem Life
Enchantment Decoy Totem Area Of Effect 1	Merciless Labyrinth	16% increased Decoy Totem Area of Effect
Enchantment Decoy Totem Area Of Effect 2	Eternal Labyrinth	24% increased Decoy Totem Area of Effect
Enchantment Desecrate Additional Corpse 1	Merciless Labyrinth	Desecrate Spawns 2 additional corpses
Enchantment Desecrate Additional Corpse 2	Eternal Labyrinth	Desecrate Spawns 3 additional corpses
Enchantment Despair Duration 1	Merciless Labyrinth	30% increased Despair Duration
Enchantment Despair Duration 2	Eternal Labyrinth	45% increased Despair Duration
Enchantment Despair Effect 1	Merciless Labyrinth	20% increased Despair Curse Effect
Enchantment Despair Effect 2	Eternal Labyrinth	30% increased Despair Curse Effect
Enchantment Determination Mana Reservation 1	Merciless Labyrinth	Determination has 10% reduced Mana Reservation
Enchantment Determination Mana Reservation 2	Eternal Labyrinth	Determination has 15% reduced Mana Reservation
Enchantment Detonate Dead Damage 1	Merciless Labyrinth	25% increased Detonate Dead Damage
Enchantment Detonate Dead Damage 2	Eternal Labyrinth	40% increased Detonate Dead Damage
Enchantment Detonate Dead Percent Chance To Detonate Additional Corpse 1	Merciless Labyrinth	Detonate Dead has a 30% chance to detonate an additional corpse
Enchantment Detonate Dead Percent Chance To Detonate Additional Corpse 2	Eternal Labyrinth	Detonate Dead has a 45% chance to detonate an additional corpse
Enchantment Detonate Dead Area Of Effect 1	Merciless Labyrinth	16% increased Detonate Dead Area of Effect
Enchantment Detonate Dead Area Of Effect 2	Eternal Labyrinth	24% increased Detonate Dead Area of Effect
Enchantment Devouring Totem Leech Per Second 1	Merciless Labyrinth	24% increased Devouring Totem Leech per second
Enchantment Devouring Totem Leech Per Second 2	Eternal Labyrinth	36% increased Devouring Totem Leech per second
Enchantment Devouring Totem Percent Chance To Consume Additional Corpse 1	Merciless Labyrinth	Devouring Totem has 40% Chance to Consume an additional corpse
Enchantment Devouring Totem Percent Chance To Consume Additional Corpse 2	Eternal Labyrinth	Devouring Totem has 60% Chance to Consume an additional corpse
Enchantment Discharge Radius 1	Merciless Labyrinth	Discharge has +3 to Radius
Enchantment Discharge Radius 2	Eternal Labyrinth	Discharge has +5 to Radius
Enchantment Discharge Consume Charges 1	Merciless Labyrinth	20% chance for Discharge to deal Damage without removing Charges
Enchantment Discharge Consume Charges 2	Eternal Labyrinth	30% chance for Discharge to deal Damage without removing Charges
Enchantment Discharge Damage 1	Merciless Labyrinth	25% increased Discharge Damage
Enchantment Discharge Damage 2	Eternal Labyrinth	40% increased Discharge Damage
Enchantment Discipline Mana Reservation 1	Merciless Labyrinth	Discipline has 14% reduced Mana Reservation
Enchantment Discipline Mana Reservation 2	Eternal Labyrinth	Discipline has 20% reduced Mana Reservation
Enchantment Divine Ire Beam Width 1	Merciless Labyrinth	Divine Ire's beam has 10% increased width
Enchantment Divine Ire Beam Width 2	Eternal Labyrinth	Divine Ire's beam has 15% increased width
Enchantment Divine Ire Damage 1	Merciless Labyrinth	Divine Ire deals 25% increased Damage
Enchantment Divine Ire Damage 2	Eternal Labyrinth	Divine Ire deals 40% increased Damage
Enchantment Divine Ire Number Of Additional Nearby Enemies To Zap 1	Merciless Labyrinth	Divine Ire Damages an additional nearby Enemy when gaining Stages
Enchantment Divine Ire Number Of Additional Nearby Enemies To Zap 2	Eternal Labyrinth	Divine Ire Damages 2 additional nearby Enemies when gaining Stages
Enchantment Dominating Blow Additional Magic 1	Merciless Labyrinth	Dominating Blow can summon 2 additional Magic Sentinels of Dominance
Enchantment Dominating Blow Additional Magic 2	Eternal Labyrinth	Dominating Blow can summon 3 additional Magic Sentinels of Dominance
Enchantment Dominating Blow Additional Rare 1	Eternal Labyrinth	Dominating Blow can summon an additional Rare Sentinel of Dominance
Enchantment Dominating Blow Duration 1	Merciless Labyrinth	20% increased Sentinel of Dominance Duration
Enchantment Dominating Blow Duration 2	Eternal Labyrinth	30% increased Sentinel of Dominance Duration
Enchantment Double Slash Added Phys To Bleeding 1	Merciless Labyrinth	Lacerate deals (4-8) to (10-15) added Physical Damage against Bleeding Enemies
Enchantment Double Slash Added Phys To Bleeding 2	Eternal Labyrinth	Lacerate deals (14-18) to (20-25) added Physical Damage against Bleeding Enemies
Enchantment Double Slash Critical Strikes 1	Merciless Labyrinth	40% increased Lacerate Critical Strike Chance
Enchantment Double Slash Critical Strikes 2	Eternal Labyrinth	60% increased Lacerate Critical Strike Chance
Enchantment Lacerate Damage 1	Merciless Labyrinth	25% increased Lacerate Damage
Enchantment Lacerate Damage 2	Eternal Labyrinth	40% increased Lacerate Damage
Enchantment Double Slash Area Of Effect 1	Merciless Labyrinth	16% increased Lacerate Area of Effect
Enchantment Double Slash Area Of Effect 2	Eternal Labyrinth	24% increased Lacerate Area of Effect
Enchantment Double Strike Attack Speed 1	Merciless Labyrinth	10% increased Double Strike Attack Speed
Enchantment Double Strike Attack Speed 2	Eternal Labyrinth	15% increased Double Strike Attack Speed
Enchantment Double Strike Critical Strike Chance 1	Merciless Labyrinth	60% increased Double Strike Critical Strike Chance
Enchantment Double Strike Critical Strike Chance 2	Eternal Labyrinth	90% increased Double Strike Critical Strike Chance
Enchantment Double Strike Damage 1	Merciless Labyrinth	25% increased Double Strike Damage
Enchantment Double Strike Damage 2	Eternal Labyrinth	40% increased Double Strike Damage
Enchantment Double Strike Double Damage Vs Bleeding 1	Merciless Labyrinth	Double Strike has a 10% chance to deal Double Damage to Bleeding Enemies
Enchantment Double Strike Double Damage Vs Bleeding 2	Eternal Labyrinth	Double Strike has a 15% chance to deal Double Damage to Bleeding Enemies
Enchantment Dread Banner Effect 1	Merciless Labyrinth	Dread Banner has 25% increased Aura Effect
Enchantment Dread Banner Effect 2	Eternal Labyrinth	Dread Banner has 40% increased Aura Effect
Enchantment Dual Strike Attack Speed 1	Merciless Labyrinth	10% increased Dual Strike Attack Speed
Enchantment Dual Strike Attack Speed 2	Eternal Labyrinth	15% increased Dual Strike Attack Speed
Enchantment Dual Strike Critical Strike Chance 1	Merciless Labyrinth	60% increased Dual Strike Critical Strike Chance
Enchantment Dual Strike Critical Strike Chance 2	Eternal Labyrinth	90% increased Dual Strike Critical Strike Chance
Enchantment Dual Strike Damage 1	Merciless Labyrinth	25% increased Dual Strike Damage
Enchantment Dual Strike Damage 2	Eternal Labyrinth	40% increased Dual Strike Damage
Enchantment Earthquake Damage 1	Merciless Labyrinth	25% increased Earthquake Damage
Enchantment Earthquake Damage 2	Eternal Labyrinth	40% increased Earthquake Damage
Enchantment Earthquake Damage per 0.1s Duration 1	Merciless Labyrinth	Earthquake deals 5% increased Damage per 0.1 seconds Duration
Enchantment Earthquake Damage per 0.1s Duration 2	Eternal Labyrinth	Earthquake deals 8% increased Damage per 0.1 seconds Duration
Enchantment Earthquake Area Of Effect 1	Merciless Labyrinth	16% increased Earthquake Area of Effect
Enchantment Earthquake Area Of Effect 2	Eternal Labyrinth	24% increased Earthquake Area of Effect
Enchantment Earthshatter Damage 1	Merciless Labyrinth	Earthshatter deals 25% increased Damage
Enchantment Earthshatter Damage 2	Eternal Labyrinth	Earthshatter deals 40% increased Damage
Enchantment Earthshatter Radius 1	Merciless Labyrinth	Earthshatter has 16% increased Area of Effect
Enchantment Earthshatter Radius 2	Eternal Labyrinth	Earthshatter has 24% increased Area of Effect
Enchantment Earthshatter Additional Spike 1	Eternal Labyrinth	Earthshatter creates +1 fissures
Enchantment Elemental Hit Attack Speed 1	Merciless Labyrinth	10% increased Elemental Hit Attack Speed
Enchantment Elemental Hit Attack Speed 2	Eternal Labyrinth	15% increased Elemental Hit Attack Speed
Enchantment Elemental Hit Chance To Freeze Shock Ignite 1	Merciless Labyrinth	Elemental Hit has +20% chance to Freeze, Shock and Ignite
Enchantment Elemental Hit Chance To Freeze Shock Ignite 2	Eternal Labyrinth	Elemental Hit has +30% chance to Freeze, Shock and Ignite
Enchantment Elemental Hit Damage 1	Merciless Labyrinth	Elemental Hit deals 25% increased Damage
Enchantment Elemental Hit Damage 2	Eternal Labyrinth	Elemental Hit deals 40% increased Damage
Enchantment Elemental Weakness Curse Effect 1	Merciless Labyrinth	20% increased Elemental Weakness Curse Effect
Enchantment Elemental Weakness Curse Effect 2	Eternal Labyrinth	30% increased Elemental Weakness Curse Effect
Enchantment Elemental Weakness Duration 1	Merciless Labyrinth	30% increased Elemental Weakness Duration
Enchantment Elemental Weakness Duration 2	Eternal Labyrinth	45% increased Elemental Weakness Duration
Enchantment Enduring Cry Additional Endurance Charge 1	Eternal Labyrinth	Enduring Cry grants 1 additional Endurance Charge
Enchantment Enduring Cry Cooldown Speed 1	Merciless Labyrinth	Enduring Cry has 20% increased Cooldown Recovery Rate
Enchantment Enduring Cry Cooldown Speed 2	Eternal Labyrinth	Enduring Cry has 30% increased Cooldown Recovery Rate
Enchantment Enfeeble Curse Effect 1	Merciless Labyrinth	20% increased Enfeeble Curse Effect
Enchantment Enfeeble Curse Effect 2	Eternal Labyrinth	30% increased Enfeeble Curse Effect
Enchantment Enfeeble Duration 1	Merciless Labyrinth	30% increased Enfeeble Duration
Enchantment Enfeeble Duration 2	Eternal Labyrinth	45% increased Enfeeble Duration
Enchantment Ensnaring Arrow Area Of Effect 1	Merciless Labyrinth	Ensnaring Arrow has 60% increased Area of Effect
Enchantment Ensnaring Arrow Area Of Effect 2	Eternal Labyrinth	Ensnaring Arrow has 90% increased Area of Effect
Enchantment Ensnaring Arrow Debuff Effect 1	Merciless Labyrinth	Ensnaring Arrow has 20% increased Debuff Effect
Enchantment Ensnaring Arrow Debuff Effect 2	Eternal Labyrinth	Ensnaring Arrow has 30% increased Debuff Effect
Enchantment Essence Drain Damage 1	Merciless Labyrinth	25% increased Essence Drain Damage
Enchantment Essence Drain Damage 2	Eternal Labyrinth	40% increased Essence Drain Damage
Enchantment Essence Drain Duration 1	Merciless Labyrinth	20% increased Essence Drain Duration
Enchantment Essence Drain Duration 2	Eternal Labyrinth	30% increased Essence Drain Duration
Enchantment Ethereal Knives Damage 1	Merciless Labyrinth	25% increased Ethereal Knives Damage
Enchantment Ethereal Knives Damage 2	Eternal Labyrinth	40% increased Ethereal Knives Damage
Enchantment Ethereal Knives Number Of Targets To Pierce 1	Eternal Labyrinth	Ethereal Knives Pierces an additional Target
Enchantment Ethereal Knives Projectile Speed 1	Merciless Labyrinth	20% increased Ethereal Knives Projectile Speed
Enchantment Ethereal Knives Projectile Speed 2	Eternal Labyrinth	30% increased Ethereal Knives Projectile Speed
Enchantment Explosive Arrow Attack Speed 1	Merciless Labyrinth	Explosive Arrow has 10% increased Attack Speed
Enchantment Explosive Arrow Attack Speed 2	Eternal Labyrinth	Explosive Arrow has 15% increased Attack Speed
Enchantment Explosive Arrow Damage 1	Merciless Labyrinth	Explosive Arrow deals 25% increased Damage
Enchantment Explosive Arrow Damage 2	Eternal Labyrinth	Explosive Arrow deals 40% increased Damage
Enchantment Explosive Arrow Increased Duration 1	Merciless Labyrinth	Explosive Arrow has 25% increased Duration
Enchantment Explosive Arrow Increased Duration 2	Eternal Labyrinth	Explosive Arrow has 40% increased Duration
Enchantment Explosive Arrow Area Of Effect 1	Merciless Labyrinth	Explosive Arrow has 16% increased Area of Effect
Enchantment Explosive Arrow Area Of Effect 2	Eternal Labyrinth	Explosive Arrow has 24% increased Area of Effect
Enchantment Explosive Arrow Reduced Duration 1	Merciless Labyrinth	Explosive Arrow has 20% reduced Duration
Enchantment Explosive Arrow Reduced Duration 2	Eternal Labyrinth	Explosive Arrow has 30% reduced Duration
Enchantment Fireball Cast Speed 1	Merciless Labyrinth	8% increased Fireball Cast Speed
Enchantment Fireball Cast Speed 2	Eternal Labyrinth	12% increased Fireball Cast Speed
Enchantment Fireball Damage 1	Merciless Labyrinth	25% increased Fireball Damage
Enchantment Fireball Damage 2	Eternal Labyrinth	40% increased Fireball Damage
Enchantment Fireball Ignite Chance 1	Merciless Labyrinth	Fireball has +20% chance to Ignite
Enchantment Fireball Ignite Chance 2	Eternal Labyrinth	Fireball has +30% chance to Ignite
Enchantment Fire Beam Cast Speed 1	Merciless Labyrinth	8% increased Scorching Ray Cast Speed
Enchantment Fire Beam Cast Speed 2	Eternal Labyrinth	12% increased Scorching Ray Cast Speed
Enchantment Scorching Ray Damage 1	Merciless Labyrinth	25% increased Scorching Ray Damage
Enchantment Scorching Ray Damage 2	Eternal Labyrinth	40% increased Scorching Ray Damage
Enchantment Fire Beam Length 1	Merciless Labyrinth	10% increased Scorching Ray beam length
Enchantment Fire Beam Length 2	Eternal Labyrinth	15% increased Scorching Ray beam length
Enchantment Firestorm Damage 1	Merciless Labyrinth	25% increased Firestorm Damage
Enchantment Firestorm Damage 2	Eternal Labyrinth	40% increased Firestorm Damage
Enchantment Firestorm Duration 1	Merciless Labyrinth	20% increased Firestorm Duration
Enchantment Firestorm Duration 2	Eternal Labyrinth	30% increased Firestorm Duration
Enchantment Firestorm Explosion Area Of Effect 1	Merciless Labyrinth	16% increased Firestorm explosion Area of Effect
Enchantment Firestorm Explosion Area Of Effect 2	Eternal Labyrinth	24% increased Firestorm explosion Area of Effect
Enchantment Fire Trap Burning Damage 1	Merciless Labyrinth	40% increased Fire Trap Burning Damage
Enchantment Fire Trap Burning Damage 2	Eternal Labyrinth	60% increased Fire Trap Burning Damage
Enchantment Fire Trap Burning Ground Duration 1	Merciless Labyrinth	30% increased Fire Trap Burning Ground Duration
Enchantment Fire Trap Burning Ground Duration 2	Eternal Labyrinth	45% increased Fire Trap Burning Ground Duration
Enchantment Fire Trap Damage 1	Merciless Labyrinth	25% increased Fire Trap Damage
Enchantment Fire Trap Damage 2	Eternal Labyrinth	40% increased Fire Trap Damage
Enchantment Flameblast Critical Strike Chance 1	Merciless Labyrinth	60% increased Flameblast Critical Strike Chance
Enchantment Flameblast Critical Strike Chance 2	Eternal Labyrinth	90% increased Flameblast Critical Strike Chance
Enchantment Flameblast Damage 1	Merciless Labyrinth	25% increased Flameblast Damage
Enchantment Flameblast Damage 2	Eternal Labyrinth	40% increased Flameblast Damage
Enchantment Flameblast Area Of Effect 1	Merciless Labyrinth	16% increased Flameblast Area of Effect
Enchantment Flameblast Area Of Effect 2	Eternal Labyrinth	24% increased Flameblast Area of Effect
Enchantment Flame Dash Cooldown Speed 1	Merciless Labyrinth	Flame Dash has 20% increased Cooldown Recovery Rate
Enchantment Flame Dash Cooldown Speed 2	Eternal Labyrinth	Flame Dash has 30% increased Cooldown Recovery Rate
Enchantment Flame Dash Damage 1	Merciless Labyrinth	25% increased Flame Dash Damage
Enchantment Flame Dash Damage 2	Eternal Labyrinth	40% increased Flame Dash Damage
Enchantment Flame Golem Elemental Resistances 1	Merciless Labyrinth	+24% to increased Flame Golem Elemental Resistances
Enchantment Flame Golem Elemental Resistances 2	Eternal Labyrinth	+36% to increased Flame Golem Elemental Resistances
Enchantment Flame Golem Granted Buff Effect 1	Merciless Labyrinth	100% increased Effect of the Buff granted by your Flame Golems
Enchantment Flame Golem Granted Buff Effect 2	Eternal Labyrinth	150% increased Effect of the Buff granted by your Flame Golems
Enchantment Flame Surge Critical Strike Chance 1	Merciless Labyrinth	60% increased Flame Surge Critical Strike Chance
Enchantment Flame Surge Critical Strike Chance 2	Eternal Labyrinth	90% increased Flame Surge Critical Strike Chance
Enchantment Flame Surge Damage 1	Merciless Labyrinth	25% increased Flame Surge Damage
Enchantment Flame Surge Damage 2	Eternal Labyrinth	40% increased Flame Surge Damage
Enchantment Flame Surge Vs Burning Enemies 1	Merciless Labyrinth	40% increased Flame Surge Damage against Burning Enemies
Enchantment Flame Surge Vs Burning Enemies 2	Eternal Labyrinth	60% increased Flame Surge Damage against Burning Enemies
Enchantment Flamethrower Additional Flamethrowers 1	Merciless Labyrinth	Flamethrower Trap has an additional Flame
Enchantment Flamethrower Additional Flamethrowers 2	Eternal Labyrinth	Flamethrower Trap has 2 additional Flames
Enchantment Flamethrower Trap Cast Speed 1	Merciless Labyrinth	Flamethrower Trap has 8% increased Cast Speed
Enchantment Flamethrower Trap Cast Speed 2	Eternal Labyrinth	Flamethrower Trap has 12% increased Cast Speed
Enchantment Flamethrower Trap Cooldown Speed 1	Merciless Labyrinth	Flamethrower Trap has 10% increased Cooldown Recovery Rate
Enchantment Flamethrower Trap Cooldown Speed 2	Eternal Labyrinth	Flamethrower Trap has 15% increased Cooldown Recovery Rate
Enchantment Flamethrower Trap Damage 1	Merciless Labyrinth	Flamethrower Trap deals 25% increased Damage
Enchantment Flamethrower Trap Damage 2	Eternal Labyrinth	Flamethrower Trap deals 40% increased Damage
Enchantment Flamethrower Trap Duration 1	Merciless Labyrinth	Flamethrower Trap has 20% increased Skill Effect Duration
Enchantment Flamethrower Trap Duration 2	Eternal Labyrinth	Flamethrower Trap has 30% increased Skill Effect Duration
Enchantment Flame Totem Consecrated Ground Enemy Damage Taken 1	Merciless Labyrinth	Consecrated Ground from Holy Flame Totem applies 6% increased Damage taken to Enemies
Enchantment Flame Totem Consecrated Ground Enemy Damage Taken 2	Eternal Labyrinth	Consecrated Ground from Holy Flame Totem applies 9% increased Damage taken to Enemies
Enchantment Flame Totem Damage 1	Merciless Labyrinth	Holy Flame Totem deals 25% increased Damage
Enchantment Flame Totem Damage 2	Eternal Labyrinth	Holy Flame Totem deals 40% increased Damage
Enchantment Flame Totem Num Of Additional Projectiles 1	Merciless Labyrinth	Holy Flame Totem fires an additional Projectile
Enchantment Flame Totem Num Of Additional Projectiles 2	Eternal Labyrinth	Holy Flame Totem fires 2 additional Projectiles
Enchantment Flame Totem Projectile Speed 1	Merciless Labyrinth	Holy Flame Totem has 20% increased Projectile Speed
Enchantment Flame Totem Projectile Speed 2	Eternal Labyrinth	Holy Flame Totem has 30% increased Projectile Speed
Enchantment Flame Wall Added Damage 1	Merciless Labyrinth	Flame Wall grants 19 to 28 Added Fire Damage to Projectiles
Enchantment Flame Wall Added Damage 2	Eternal Labyrinth	Flame Wall grants 31 to 47 Added Fire Damage to Projectiles
Enchantment Flame Wall Damage 1	Merciless Labyrinth	Flame Wall deals 25% increased Damage
Enchantment Flame Wall Damage 2	Eternal Labyrinth	Flame Wall deals 40% increased Damage
Enchantment Flame Wall Count 1	Eternal Labyrinth	N/A
Enchantment Flammability Curse Effect 1	Merciless Labyrinth	20% increased Flammability Curse Effect
Enchantment Flammability Curse Effect 2	Eternal Labyrinth	30% increased Flammability Curse Effect
Enchantment Flammability Duration 1	Merciless Labyrinth	30% increased Flammability Duration
Enchantment Flammability Duration 2	Eternal Labyrinth	45% increased Flammability Duration
Enchantment Flesh and Stone Mana Reservation 1	Merciless Labyrinth	Flesh and Stone has 20% reduced Mana Reservation
Enchantment Flesh and Stone Mana Reservation 2	Eternal Labyrinth	Flesh and Stone has 30% reduced Mana Reservation
Enchantment Flesh Offering Attack Speed 1	Merciless Labyrinth	Flesh Offering grants an additional 14% increased Attack Speed
Enchantment Flesh Offering Attack Speed 2	Eternal Labyrinth	Flesh Offering grants an additional 21% increased Attack Speed
Enchantment Flesh Offering Duration 1	Merciless Labyrinth	30% increased Flesh Offering Duration
Enchantment Flesh Offering Duration 2	Eternal Labyrinth	45% increased Flesh Offering Duration
Enchantment Flicker Strike Cooldown Speed 1	Merciless Labyrinth	Flicker Strike has 20% increased Cooldown Recovery Rate
Enchantment Flicker Strike Cooldown Speed 2	Eternal Labyrinth	Flicker Strike has 30% increased Cooldown Recovery Rate
Enchantment Flicker Strike Damage 1	Merciless Labyrinth	25% increased Flicker Strike Damage
Enchantment Flicker Strike Damage 2	Eternal Labyrinth	40% increased Flicker Strike Damage
Enchantment Flicker Strike Damage Per Frenzy Charge 1	Merciless Labyrinth	6% increased Flicker Strike Damage per Frenzy Charge
Enchantment Flicker Strike Damage Per Frenzy Charge 2	Eternal Labyrinth	9% increased Flicker Strike Damage per Frenzy Charge
Enchantment Freezing Pulse Cast Speed 1	Merciless Labyrinth	8% increased Freezing Pulse Cast Speed
Enchantment Freezing Pulse Cast Speed 2	Eternal Labyrinth	12% increased Freezing Pulse Cast Speed
Enchantment Freezing Pulse Damage 1	Merciless Labyrinth	25% increased Freezing Pulse Damage
Enchantment Freezing Pulse Damage 2	Eternal Labyrinth	40% increased Freezing Pulse Damage
Enchantment Freezing Pulse Projectile Speed 1	Merciless Labyrinth	20% increased Freezing Pulse Projectile Speed
Enchantment Freezing Pulse Projectile Speed 2	Eternal Labyrinth	30% increased Freezing Pulse Projectile Speed
Enchantment Frenzy Damage 1	Merciless Labyrinth	25% increased Frenzy Damage
Enchantment Frenzy Damage 2	Eternal Labyrinth	40% increased Frenzy Damage
Enchantment Frenzy Damage Per Frenzy Charge 1	Merciless Labyrinth	6% increased Frenzy Damage per Frenzy Charge
Enchantment Frenzy Damage Per Frenzy Charge 2	Eternal Labyrinth	9% increased Frenzy Damage per Frenzy Charge
Enchantment Frenzy Percent Chance To Gain Additional Frenzy Charge 1	Merciless Labyrinth	20% Chance on Frenzy to gain an additional Frenzy Charge
Enchantment Frenzy Percent Chance To Gain Additional Frenzy Charge 2	Eternal Labyrinth	30% Chance on Frenzy to gain an additional Frenzy Charge
Enchantment Frostbite Curse Effect 1	Merciless Labyrinth	20% increased Frostbite Curse Effect
Enchantment Frostbite Curse Effect 2	Eternal Labyrinth	30% increased Frostbite Curse Effect
Enchantment Frostbite Duration 1	Merciless Labyrinth	30% increased Frostbite Duration
Enchantment Frostbite Duration 2	Eternal Labyrinth	45% increased Frostbite Duration
Enchantment Frost Blades Damage 1	Merciless Labyrinth	25% increased Frost Blades Damage
Enchantment Frost Blades Damage 2	Eternal Labyrinth	40% increased Frost Blades Damage
Enchantment Frost Blades Projectile Speed 1	Merciless Labyrinth	20% increased Frost Blades Projectile Speed
Enchantment Frost Blades Projectile Speed 2	Eternal Labyrinth	30% increased Frost Blades Projectile Speed
Enchantment Frostblink Cooldown Speed 1	Merciless Labyrinth	Frostblink has 20% increased Cooldown Recovery Rate
Enchantment Frostblink Cooldown Speed 2	Eternal Labyrinth	Frostblink has 30% increased Cooldown Recovery Rate
Enchantment Frostblink Travel Distance 1	Merciless Labyrinth	Frostblink has 50% increased maximum travel distance
Enchantment Frostblink Travel Distance 2	Eternal Labyrinth	Frostblink has 75% increased maximum travel distance
Enchantment Frost Bolt Cast Speed 1	Merciless Labyrinth	10% increased Frostbolt Cast Speed
Enchantment Frost Bolt Cast Speed 2	Eternal Labyrinth	15% increased Frostbolt Cast Speed
Enchantment Frost Bolt Damage 1	Merciless Labyrinth	25% increased Frostbolt Damage
Enchantment Frost Bolt Damage 2	Eternal Labyrinth	40% increased Frostbolt Damage
Enchantment Frost Bolt Freeze Chance 1	Merciless Labyrinth	Frostbolt has +10% chance to Freeze
Enchantment Frost Bolt Freeze Chance 2	Eternal Labyrinth	Frostbolt has +15% chance to Freeze
Enchantment Frost Bomb Cooldown Speed 1	Merciless Labyrinth	Frost Bomb has 20% increased Cooldown Recovery Rate
Enchantment Frost Bomb Cooldown Speed 2	Eternal Labyrinth	Frost Bomb has 30% increased Cooldown Recovery Rate
Enchantment Frost Bomb Damage 1	Merciless Labyrinth	25% increased Frost Bomb Damage
Enchantment Frost Bomb Damage 2	Eternal Labyrinth	40% increased Frost Bomb Damage
Enchantment Frost Bomb Increased Duration 1	Merciless Labyrinth	Frost Bomb has 20% increased Debuff Duration
Enchantment Frost Bomb Increased Duration 2	Eternal Labyrinth	Frost Bomb has 30% increased Debuff Duration
Enchantment Frost Bomb Area Of Effect 1	Merciless Labyrinth	16% increased Frost Bomb Area of Effect
Enchantment Frost Bomb Area Of Effect 2	Eternal Labyrinth	24% increased Frost Bomb Area of Effect
Enchantment Frost Fury Additional Max Number Of Stages 1	Eternal Labyrinth	Winter Orb has +2 Maximum Stages
Enchantment Frost Fury Area Of Effect Per Stage 1	Merciless Labyrinth	Winter Orb has 2% increased Area of Effect per Stage
Enchantment Frost Fury Area Of Effect Per Stage 2	Eternal Labyrinth	Winter Orb has 3% increased Area of Effect per Stage
Enchantment Frost Shield Cooldown Count 1	Eternal Labyrinth	Frost Shield has +1 Cooldown Use
Enchantment Frost Shield Health per Stage 1	Merciless Labyrinth	N/A
Enchantment Frost Shield Health per Stage 2	Eternal Labyrinth	N/A
Enchantment Frost Wall Cooldown Speed 1	Merciless Labyrinth	Frost Wall has 20% increased Cooldown Recovery Rate
Enchantment Frost Wall Cooldown Speed 2	Eternal Labyrinth	Frost Wall has 30% increased Cooldown Recovery Rate
Enchantment Frost Wall Duration 1	Merciless Labyrinth	24% increased Frost Wall Duration
Enchantment Frost Wall Duration 2	Eternal Labyrinth	36% increased Frost Wall Duration
Enchantment Galvanic Arrow Projectile Speed 1	Merciless Labyrinth	Galvanic Arrow has 20% increased Projectile Speed
Enchantment Galvanic Arrow Projectile Speed 2	Eternal Labyrinth	Galvanic Arrow has 30% increased Projectile Speed
Enchantment General's Cry Additional Mirage Warrior 1	Eternal Labyrinth	General's Cry has +1 to maximum number of Mirage Warriors
Enchantment General's Cry Cooldown Speed 1	Merciless Labyrinth	General's Cry has 20% increased Cooldown Recovery Rate
Enchantment General's Cry Cooldown Speed 2	Eternal Labyrinth	General's Cry has 30% increased Cooldown Recovery Rate
Enchantment Glacial Cascade Damage 1	Merciless Labyrinth	25% increased Glacial Cascade Damage
Enchantment Glacial Cascade Damage 2	Eternal Labyrinth	40% increased Glacial Cascade Damage
Enchantment Glacial Cascade Physical Damage Percent To Add As Cold 1	Merciless Labyrinth	Glacial Cascade gains 6% of Physical Damage as Extra Cold Damage
Enchantment Glacial Cascade Physical Damage Percent To Add As Cold 2	Eternal Labyrinth	Glacial Cascade gains 10% of Physical Damage as Extra Cold Damage
Enchantment Glacial Cascade Area Of Effect 1	Merciless Labyrinth	16% increased Glacial Cascade Area of Effect
Enchantment Glacial Cascade Area Of Effect 2	Eternal Labyrinth	24% increased Glacial Cascade Area of Effect
Enchantment Glacial Hammer Damage 1	Merciless Labyrinth	25% increased Glacial Hammer Damage
Enchantment Glacial Hammer Damage 2	Eternal Labyrinth	40% increased Glacial Hammer Damage
Enchantment Glacial Hammer Freeze Chance 1	Merciless Labyrinth	Glacial Hammer has +20% chance to Freeze
Enchantment Glacial Hammer Freeze Chance 2	Eternal Labyrinth	Glacial Hammer has +30% chance to Freeze
Enchantment Glacial Hammer Physical Damage Percent To Add As Cold Damage 1	Merciless Labyrinth	10% of Glacial Hammer Physical Damage gained as Extra Cold Damage
Enchantment Glacial Hammer Physical Damage Percent To Add As Cold Damage 2	Eternal Labyrinth	15% of Glacial Hammer Physical Damage gained as Extra Cold Damage
Enchantment Grace Mana Reservation 1	Merciless Labyrinth	Grace has 10% reduced Mana Reservation
Enchantment Grace Mana Reservation 2	Eternal Labyrinth	Grace has 15% reduced Mana Reservation
Enchantment Ground Slam Angle 1	Merciless Labyrinth	Ground Slam has a 16% increased angle
Enchantment Ground Slam Angle 2	Eternal Labyrinth	Ground Slam has a 24% increased angle
Enchantment Ground Slam Damage 1	Merciless Labyrinth	25% increased Ground Slam Damage
Enchantment Ground Slam Damage 2	Eternal Labyrinth	40% increased Ground Slam Damage
Enchantment Ground Slam Area Of Effect 1	Merciless Labyrinth	16% increased Ground Slam Area of Effect
Enchantment Ground Slam Area Of Effect 2	Eternal Labyrinth	24% increased Ground Slam Area of Effect
Enchantment Haste Mana Reservation 1	Merciless Labyrinth	Haste has 10% reduced Mana Reservation
Enchantment Haste Mana Reservation 2	Eternal Labyrinth	Haste has 15% reduced Mana Reservation
Enchantment Hatred Mana Reservation 1	Merciless Labyrinth	Hatred has 10% reduced Mana Reservation
Enchantment Hatred Mana Reservation 2	Eternal Labyrinth	Hatred has 15% reduced Mana Reservation
Enchantment Heavy Strike Attack Speed 1	Merciless Labyrinth	10% increased Heavy Strike Attack Speed
Enchantment Heavy Strike Attack Speed 2	Eternal Labyrinth	15% increased Heavy Strike Attack Speed
Enchantment Heavy Strike Damage 1	Merciless Labyrinth	25% increased Heavy Strike Damage
Enchantment Heavy Strike Damage 2	Eternal Labyrinth	40% increased Heavy Strike Damage
Enchantment Heavy Strike Double Damage 1	Merciless Labyrinth	Heavy Strike has a 8% chance to deal Double Damage
Enchantment Heavy Strike Double Damage 2	Eternal Labyrinth	Heavy Strike has a 12% chance to deal Double Damage
Enchantment Herald Of Agony Mana Reservation 1	Merciless Labyrinth	Herald of Agony has 20% reduced Reservation
Enchantment Herald Of Agony Mana Reservation 2	Eternal Labyrinth	Herald of Agony has 30% reduced Reservation
Enchantment Herald Of Agony Num Of Secondary Projectiles 1	Eternal Labyrinth	Summoned Agony Crawler fires 2 additional Projectiles
Enchantment Herald Of Ash Damage 1	Merciless Labyrinth	25% increased Herald of Ash Damage
Enchantment Herald Of Ash Damage 2	Eternal Labyrinth	40% increased Herald of Ash Damage
Enchantment Herald Of Ash Mana Reservation 1	Merciless Labyrinth	Herald of Ash has 20% reduced Mana Reservation
Enchantment Herald Of Ash Mana Reservation 2	Eternal Labyrinth	Herald of Ash has 30% reduced Mana Reservation
Enchantment Herald Of Ice Damage 1	Merciless Labyrinth	25% increased Herald of Ice Damage
Enchantment Herald Of Ice Damage 2	Eternal Labyrinth	40% increased Herald of Ice Damage
Enchantment Herald Of Ice Mana Reservation 1	Merciless Labyrinth	Herald of Ice has 20% reduced Mana Reservation
Enchantment Herald Of Ice Mana Reservation 2	Eternal Labyrinth	Herald of Ice has 30% reduced Mana Reservation
Enchantment Herald Of Purity Additional Minion 1	Eternal Labyrinth	+1 to maximum number of Sentinels of Purity
Enchantment Herald Of Purity Mana Reservation 1	Merciless Labyrinth	Herald of Purity has 20% reduced Mana Reservation
Enchantment Herald Of Purity Mana Reservation 2	Eternal Labyrinth	Herald of Purity has 30% reduced Mana Reservation
Enchantment Herald Of Thunder Damage 1	Merciless Labyrinth	25% increased Herald of Thunder Damage
Enchantment Herald Of Thunder Damage 2	Eternal Labyrinth	40% increased Herald of Thunder Damage
Enchantment Herald Of Thunder Mana Reservation 1	Merciless Labyrinth	Herald of Thunder has 20% reduced Mana Reservation
Enchantment Herald Of Thunder Mana Reservation 2	Eternal Labyrinth	Herald of Thunder has 30% reduced Mana Reservation
Enchantment Hexblast Chance to not Consume Hex 1	Merciless Labyrinth	Hexblast has 10% chance to not remove a Hex
Enchantment Hexblast Chance to not Consume Hex 2	Eternal Labyrinth	Hexblast has 15% chance to not remove a Hex
Enchantment Hexblast Damage 1	Merciless Labyrinth	Hexblast deals 25% increased Damage
Enchantment Hexblast Damage 2	Eternal Labyrinth	Hexblast deals 40% increased Damage
Enchantment Hexblast Area Of Effect 1	Merciless Labyrinth	Hexblast has 16% increased Area of Effect
Enchantment Hexblast Area Of Effect 2	Eternal Labyrinth	Hexblast has 24% increased Area of Effect
Enchantment Holy Relic Buff Effect 1	Merciless Labyrinth	Summoned Holy Relics have 75% increased Buff Effect
Enchantment Holy Relic Buff Effect 2	Eternal Labyrinth	Summoned Holy Relics have 100% increased Buff Effect
Enchantment Holy Relic Damage 1	Merciless Labyrinth	Summoned Holy Relics deal 25% increased Damage
Enchantment Holy Relic Damage 2	Eternal Labyrinth	Summoned Holy Relics deal 40% increased Damage
Enchantment Holy Relic Area Of Effect 1	Merciless Labyrinth	Summoned Holy Relics have 16% increased Area of Effect
Enchantment Holy Relic Area Of Effect 2	Eternal Labyrinth	Summoned Holy Relics have 24% increased Area of Effect
Enchantment Ice Crash Damage 1	Merciless Labyrinth	25% increased Ice Crash Damage
Enchantment Ice Crash Damage 2	Eternal Labyrinth	40% increased Ice Crash Damage
Enchantment Ice Crash Physical Damage Percent To Add As Cold Damage 1	Merciless Labyrinth	10% of Ice Crash Physical Damage gained as Extra Cold Damage
Enchantment Ice Crash Physical Damage Percent To Add As Cold Damage 2	Eternal Labyrinth	15% of Ice Crash Physical Damage gained as Extra Cold Damage
Enchantment Ice Crash Area Of Effect 1	Merciless Labyrinth	16% increased Ice Crash Area of Effect
Enchantment Ice Crash Area Of Effect 2	Eternal Labyrinth	24% increased Ice Crash Area of Effect
Enchantment Ice Golem Elemental Resistances 1	Merciless Labyrinth	+24% to Ice Golem Elemental Resistances
Enchantment Ice Golem Elemental Resistances 2	Eternal Labyrinth	+36% to Ice Golem Elemental Resistances
Enchantment Ice Golem Grants Percent Additional Critical Strike Chance And Accuracy 1	Merciless Labyrinth	100% increased Effect of the Buff granted by your Ice Golems
Enchantment Ice Golem Grants Percent Additional Critical Strike Chance And Accuracy 2	Eternal Labyrinth	150% increased Effect of the Buff granted by your Ice Golems
Enchantment Ice Nova Damage 1	Merciless Labyrinth	25% increased Ice Nova Damage
Enchantment Ice Nova Damage 2	Eternal Labyrinth	40% increased Ice Nova Damage
Enchantment Ice Nova Freeze Chance 1	Merciless Labyrinth	Ice Nova has +20% chance to Freeze
Enchantment Ice Nova Freeze Chance 2	Eternal Labyrinth	Ice Nova has +30% chance to Freeze
Enchantment Ice Nova Minimum Chill 1	Merciless Labyrinth	Chills from Ice Nova Hits always reduce Action Speed by at least 6%
Enchantment Ice Nova Minimum Chill 2	Eternal Labyrinth	Chills from Ice Nova Hits always reduce Action Speed by at least 8%
Enchantment Ice Nova Area Of Effect 1	Merciless Labyrinth	16% increased Ice Nova Area of Effect
Enchantment Ice Nova Area Of Effect 2	Eternal Labyrinth	24% increased Ice Nova Area of Effect
Enchantment Ice Shot Cone Angle 1	Merciless Labyrinth	Ice Shot has 30% increased Area of Effect angle
Enchantment Ice Shot Cone Angle 2	Eternal Labyrinth	Ice Shot has 60% increased Area of Effect angle
Enchantment Ice Shot Damage 1	Merciless Labyrinth	25% increased Ice Shot Damage
Enchantment Ice Shot Damage 2	Eternal Labyrinth	40% increased Ice Shot Damage
Enchantment Ice Shot Area Of Effect 1	Merciless Labyrinth	16% increased Ice Shot Area of Effect
Enchantment Ice Shot Area Of Effect 2	Eternal Labyrinth	24% increased Ice Shot Area of Effect
Enchantment Ice Siphon Trap Chill Effect 1	Merciless Labyrinth	Siphoning Trap has 25% increased Chill Effect
Enchantment Ice Siphon Trap Chill Effect 2	Eternal Labyrinth	Siphoning Trap has 40% increased Chill Effect
Enchantment Ice Siphon Trap Damage 1	Merciless Labyrinth	Siphoning Trap deals 25% increased Damage
Enchantment Ice Siphon Trap Damage 2	Eternal Labyrinth	Siphoning Trap deals 40% increased Damage
Enchantment Ice Siphon Trap Damage Taken 1	Eternal Labyrinth	Siphoning Trap's beam to you grants 1% reduced Damage taken for each other beam
Enchantment Ice Siphon Trap Duration 1	Merciless Labyrinth	Siphoning Trap has 30% increased Skill Effect Duration
Enchantment Ice Siphon Trap Duration 2	Eternal Labyrinth	Siphoning Trap has 45% increased Skill Effect Duration
Enchantment Ice Spear Additional Projectile 1	Eternal Labyrinth	Ice Spear fires an additional Projectile
Enchantment Ice Spear Distance Before Form Change 1	Merciless Labyrinth	Ice Spear travels 20% reduced distance before changing forms
Enchantment Ice Spear Distance Before Form Change 2	Eternal Labyrinth	Ice Spear travels 30% reduced distance before changing forms
Enchantment Ice Spear Percent Chance To Gain Power Charge On Critical Strike 1	Merciless Labyrinth	10% Chance to gain a Power Charge on Critical Strike with Ice Spear
Enchantment Ice Spear Percent Chance To Gain Power Charge On Critical Strike 2	Eternal Labyrinth	15% Chance to gain a Power Charge on Critical Strike with Ice Spear
Enchantment Ice Spear Second Form Critical Strike Chance 1	Merciless Labyrinth	200% increased Ice Spear Critical Strike Chance in second form
Enchantment Ice Spear Second Form Critical Strike Chance 2	Eternal Labyrinth	300% increased Ice Spear Critical Strike Chance in second form
Enchantment Ice Trap Cold Penetration 1	Merciless Labyrinth	Ice Trap Damage Penetrates 6% Cold Resistance
Enchantment Ice Trap Cold Penetration 2	Eternal Labyrinth	Ice Trap Damage Penetrates 10% Cold Resistance
Enchantment Ice Trap Damage 1	Merciless Labyrinth	25% increased Ice Trap Damage
Enchantment Ice Trap Damage 2	Eternal Labyrinth	40% increased Ice Trap Damage
Enchantment Ice Trap Area Of Effect 1	Merciless Labyrinth	16% increased Ice Trap Area of Effect
Enchantment Ice Trap Area Of Effect 2	Eternal Labyrinth	24% increased Ice Trap Area of Effect
Enchantment Immortal Call Duration 1	Merciless Labyrinth	34% increased Immortal Call Duration
Enchantment Immortal Call Duration 2	Eternal Labyrinth	36% increased Immortal Call Duration
Enchantment Incinerate Area Of Effect 1	Merciless Labyrinth	Incinerate has 16% increased Area of Effect
Enchantment Incinerate Area Of Effect 2	Eternal Labyrinth	Incinerate has 24% increased Area of Effect
Enchantment Incinerate Damage 1	Merciless Labyrinth	25% increased Incinerate Damage
Enchantment Incinerate Damage 2	Eternal Labyrinth	40% increased Incinerate Damage
Enchantment Incinerate Damage Per Stage 3	Eternal Labyrinth	10% increased Incinerate Damage for each stage
Enchantment Incinerate Maximum Stages 1	Merciless Labyrinth	Incinerate has +1 to maximum stages
Enchantment Incinerate Maximum Stages 2	Eternal Labyrinth	Incinerate has +2 to maximum stages
Enchantment Infernal Blow Damage 1	Merciless Labyrinth	25% increased Infernal Blow Damage
Enchantment Infernal Blow Damage 2	Eternal Labyrinth	40% increased Infernal Blow Damage
Enchantment Infernal Blow Increased Damage Per Stack 1	Merciless Labyrinth	Infernal Blow Debuff deals an additional 3% of Damage per Charge
Enchantment Infernal Blow Increased Damage Per Stack 2	Eternal Labyrinth	Infernal Blow Debuff deals an additional 5% of Damage per Charge
Enchantment Infernal Blow Physical Damage Percent To Add As Fire Damage 1	Merciless Labyrinth	10% of Infernal Blow Physical Damage gained as Extra Fire Damage
Enchantment Infernal Blow Physical Damage Percent To Add As Fire Damage 2	Eternal Labyrinth	15% of Infernal Blow Physical Damage gained as Extra Fire Damage
Enchantment Infernal Blow Area Of Effect 1	Merciless Labyrinth	16% increased Infernal Blow Area of Effect
Enchantment Infernal Blow Area Of Effect 2	Eternal Labyrinth	24% increased Infernal Blow Area of Effect
Enchantment Infernal Cry Combust Area Of Effect 1	Eternal Labyrinth	Combust has 30% increased Area of Effect
Enchantment Infernal Cry Cooldown Speed 1	Merciless Labyrinth	Infernal Cry has 20% increased Cooldown Recovery Rate
Enchantment Infernal Cry Cooldown Speed 2	Eternal Labyrinth	Infernal Cry has 30% increased Cooldown Recovery Rate
Enchantment Intimidating Cry Area Of Effect 1	Merciless Labyrinth	Intimidating Cry has 16% increased Area of Effect
Enchantment Intimidating Cry Area Of Effect 2	Eternal Labyrinth	Intimidating Cry has 24% increased Area of Effect
Enchantment Intimidating Cry Cooldown Speed 1	Merciless Labyrinth	Intimidating Cry has 20% increased Cooldown Recovery Rate
Enchantment Intimidating Cry Cooldown Speed 2	Eternal Labyrinth	Intimidating Cry has 30% increased Cooldown Recovery Rate
Enchantment Kinetic Blast Damage 1	Merciless Labyrinth	25% increased Kinetic Blast Damage
Enchantment Kinetic Blast Damage 2	Eternal Labyrinth	40% increased Kinetic Blast Damage
Enchantment Kinetic Blast Explosions 1	Merciless Labyrinth	Kinetic Blast has a 50% chance for an additional explosion
Enchantment Kinetic Blast Explosions 2	Eternal Labyrinth	Kinetic Blast has a 75% chance for an additional explosion
Enchantment Kinetic Blast Area Of Effect 1	Merciless Labyrinth	16% increased Kinetic Blast Area of Effect
Enchantment Kinetic Blast Area Of Effect 2	Eternal Labyrinth	24% increased Kinetic Blast Area of Effect
Enchantment Kinetic Bolt Attack Speed 1	Merciless Labyrinth	Kinetic Bolt has 10% increased Attack Speed
Enchantment Kinetic Bolt Attack Speed 2	Eternal Labyrinth	Kinetic Bolt has 15% increased Attack Speed
Enchantment Kinetic Bolt Extra Bounces 1	Merciless Labyrinth	Kinetic Bolt changes direction 1 additional time
Enchantment Kinetic Bolt Extra Bounces 2	Eternal Labyrinth	Kinetic Bolt changes direction 2 additional times
Enchantment Kinetic Bolt Projectile Speed 1	Merciless Labyrinth	Kinetic Bolt has 20% increased Projectile Speed
Enchantment Kinetic Bolt Projectile Speed 2	Eternal Labyrinth	Kinetic Bolt has 30% increased Projectile Speed
Enchantment Lancing Steel Chance To Not Consume Shards 1	Merciless Labyrinth	Lancing Steel has 20% chance count as consumeing Steel Shards without Consuming them
Enchantment Lancing Steel Chance To Not Consume Shards 2	Eternal Labyrinth	Lancing Steel has 30% chance count as consumeing Steel Shards without Consuming them
Enchantment Lancing Steel Damage 1	Merciless Labyrinth	Lancing Steel deals 25% increased Damage
Enchantment Lancing Steel Damage 2	Eternal Labyrinth	Lancing Steel deals 40% increased Damage
Enchantment Lancing Steel Number of Additional Projectiles 1	Eternal Labyrinth	Lancing Steel fires an additional Projectile
Enchantment Leap Slam Attack Speed 1	Merciless Labyrinth	10% increased Leap Slam Attack Speed
Enchantment Leap Slam Attack Speed 2	Eternal Labyrinth	15% increased Leap Slam Attack Speed
Enchantment Leap Slam Damage 1	Merciless Labyrinth	25% increased Leap Slam Damage
Enchantment Leap Slam Damage 2	Eternal Labyrinth	40% increased Leap Slam Damage
Enchantment Leap Slam Area Of Effect 1	Merciless Labyrinth	16% increased Leap Slam Area of Effect
Enchantment Leap Slam Area Of Effect 2	Eternal Labyrinth	24% increased Leap Slam Area of Effect
Enchantment Lightning Arrow Damage 1	Merciless Labyrinth	25% increased Lightning Arrow Damage
Enchantment Lightning Arrow Damage 2	Eternal Labyrinth	40% increased Lightning Arrow Damage
Enchantment Lightning Arrow Extra Targets 1	Merciless Labyrinth	Lightning Arrow hits an additional Enemy
Enchantment Lightning Arrow Extra Targets 2	Eternal Labyrinth	Lightning Arrow hits 2 additional Enemies
Enchantment Lightning Arrow Area Of Effect 1	Merciless Labyrinth	16% increased Lightning Arrow Area of Effect
Enchantment Lightning Arrow Area Of Effect 2	Eternal Labyrinth	24% increased Lightning Arrow Area of Effect
Enchantment Stormblast Mine Aura Effect 1	Merciless Labyrinth	Stormblast Mine has 20% increased Aura Effect
Enchantment Stormblast Mine Aura Effect 2	Eternal Labyrinth	Stormblast Mine has 40% increased Aura Effect
Enchantment Stormblast Mine Damage 1	Merciless Labyrinth	Stormblast Mine deals 25% increased Damage
Enchantment Stormblast Mine Damage 2	Eternal Labyrinth	Stormblast Mine deals 40% increased Damage
Enchantment Stormblast Mine Throwing Speed 1	Merciless Labyrinth	Stormblast Mine has 10% increased Throwing Speed
Enchantment Stormblast Mine Throwing Speed 2	Eternal Labyrinth	Stormblast Mine has 15% increased Throwing Speed
Enchantment Lightning Golem Elemental Resistances 1	Merciless Labyrinth	+24% to Lightning Golem Elemental Resistances
Enchantment Lightning Golem Elemental Resistances 2	Eternal Labyrinth	+36% to Lightning Golem Elemental Resistances
Enchantment Lightning Golem Granted Buff Effect 1	Merciless Labyrinth	100% increased Effect of the Buff granted by your Lightning Golems
Enchantment Lightning Golem Granted Buff Effect 2	Eternal Labyrinth	150% increased Effect of the Buff granted by your Lightning Golems
Enchantment Lightning Strike Additional Pierce 1	Merciless Labyrinth	Lightning Strike pierces 2 additional Targets
Enchantment Lightning Strike Additional Pierce 2	Eternal Labyrinth	Lightning Strike pierces 3 additional Targets
Enchantment Lightning Strike Damage 1	Merciless Labyrinth	25% increased Lightning Strike Damage
Enchantment Lightning Strike Damage 2	Eternal Labyrinth	40% increased Lightning Strike Damage
Enchantment Lightning Strike Num Of Additional Projectiles 1	Merciless Labyrinth	Lightning Strike fires 2 additional Projectiles
Enchantment Lightning Strike Num Of Additional Projectiles 2	Eternal Labyrinth	Lightning Strike fires 3 additional Projectiles
Enchantment Lightning Tendrils Critical Strike Chance 1	Merciless Labyrinth	40% increased Lightning Tendrils Critical Strike Chance
Enchantment Lightning Tendrils Critical Strike Chance 2	Eternal Labyrinth	60% increased Lightning Tendrils Critical Strike Chance
Enchantment Lightning Tendrils Damage 1	Merciless Labyrinth	25% increased Lightning Tendrils Damage
Enchantment Lightning Tendrils Damage 2	Eternal Labyrinth	40% increased Lightning Tendrils Damage
Enchantment Lightning Tendrils Area Of Effect 1	Merciless Labyrinth	16% increased Lightning Tendrils Area of Effect
Enchantment Lightning Tendrils Area Of Effect 2	Eternal Labyrinth	24% increased Lightning Tendrils Area of Effect
Enchantment Lightning Tower Trap Additional Beams 1	Eternal Labyrinth	Lightning Spire Trap strikes an additional area
Enchantment Lightning Tower Trap Cast Speed 1	Merciless Labyrinth	Lightning Spire Trap has 8% increased Cast Speed
Enchantment Lightning Tower Trap Cast Speed 2	Eternal Labyrinth	Lightning Spire Trap has 12% increased Cast Speed
Enchantment Lightning Tower Trap Cooldown Speed 1	Merciless Labyrinth	Lightning Spire Trap has 10% increased Cooldown Recovery Rate
Enchantment Lightning Tower Trap Cooldown Speed 2	Eternal Labyrinth	Lightning Spire Trap has 15% increased Cooldown Recovery Rate
Enchantment Lightning Tower Trap Damage 1	Merciless Labyrinth	Lightning Spire Trap deals 25% increased Damage
Enchantment Lightning Tower Trap Damage 2	Eternal Labyrinth	Lightning Spire Trap deals 40% increased Damage
Enchantment Lightning Tower Trap Duration 1	Merciless Labyrinth	Lightning Spire Trap has 20% increased Skill Effect Duration
Enchantment Lightning Tower Trap Duration 2	Eternal Labyrinth	Lightning Spire Trap has 30% increased Skill Effect Duration
Enchantment Lightning Trap Additional Pierce 1	Merciless Labyrinth	Lightning Trap pierces 2 additional Targets
Enchantment Lightning Trap Additional Pierce 2	Eternal Labyrinth	Lightning Trap pierces 3 additional Targets
Enchantment Lightning Trap Damage 1	Merciless Labyrinth	25% increased Lightning Trap Damage
Enchantment Lightning Trap Damage 2	Eternal Labyrinth	40% increased Lightning Trap Damage
Enchantment Lightning Trap Penetration 1	Merciless Labyrinth	Lightning Trap Damage Penetrates 6% Lightning Resistance
Enchantment Lightning Trap Penetration 2	Eternal Labyrinth	Lightning Trap Damage Penetrates 10% Lightning Resistance
Enchantment Lightning Trap Shock Effect 1	Merciless Labyrinth	25% increased Lightning Trap Lightning Ailment Effect
Enchantment Lightning Trap Shock Effect 2	Eternal Labyrinth	40% increased Lightning Trap Lightning Ailment Effect
Enchantment Lightning Warp Cast Speed 1	Merciless Labyrinth	8% increased Lightning Warp Cast Speed
Enchantment Lightning Warp Cast Speed 2	Eternal Labyrinth	12% increased Lightning Warp Cast Speed
Enchantment Lightning Warp Damage 1	Merciless Labyrinth	25% increased Lightning Warp Damage
Enchantment Lightning Warp Damage 2	Eternal Labyrinth	40% increased Lightning Warp Damage
Enchantment Lightning Warp Duration 1	Merciless Labyrinth	20% reduced Lightning Warp Duration
Enchantment Lightning Warp Duration 2	Eternal Labyrinth	30% reduced Lightning Warp Duration
Enchantment Magma Orb Damage 1	Merciless Labyrinth	25% increased Magma Orb Damage
Enchantment Magma Orb Damage 2	Eternal Labyrinth	40% increased Magma Orb Damage
Enchantment Magma Orb Num Of Additional Projectiles In Chain 2	Eternal Labyrinth	Magma Orb Chains an additional time
Enchantment Magma Orb Area Of Effect 1	Merciless Labyrinth	16% increased Magma Orb Area of Effect
Enchantment Magma Orb Area Of Effect 2	Eternal Labyrinth	24% increased Magma Orb Area of Effect
Enchantment Malevolence Mana Reservation 1	Merciless Labyrinth	Malevolence has 10% reduced Mana Reservation
Enchantment Malevolence Mana Reservation 2	Eternal Labyrinth	Malevolence has 15% reduced Mana Reservation
Enchantment Pestilent Strike Area Of Effect 1	Merciless Labyrinth	Pestilent Strike has 16% increased Area of Effect
Enchantment Pestilent Strike Area Of Effect 2	Eternal Labyrinth	Pestilent Strike has 24% increased Area of Effect
Enchantment Pestilent Strike Damage 1	Merciless Labyrinth	Pestilent Strike deals 25% increased Damage
Enchantment Pestilent Strike Damage 2	Eternal Labyrinth	Pestilent Strike deals 40% increased Damage
Enchantment Pestilent Strike Duration 1	Merciless Labyrinth	Pestilent Strike has 25% increased Duration
Enchantment Pestilent Strike Duration 2	Eternal Labyrinth	Pestilent Strike has 40% increased Duration
Enchantment Mirror Arrow Attack Speed 1	Merciless Labyrinth	Mirror Arrow and Mirror Arrow Clones have 10% increased Attack Speed
Enchantment Mirror Arrow Attack Speed 2	Eternal Labyrinth	Mirror Arrow and Mirror Arrow Clones have 15% increased Attack Speed
Enchantment Mirror Arrow Cooldown Speed 1	Merciless Labyrinth	Mirror Arrow has 20% increased Cooldown Recovery Rate
Enchantment Mirror Arrow Cooldown Speed 2	Eternal Labyrinth	Mirror Arrow has 30% increased Cooldown Recovery Rate
Enchantment Mirror Arrow Damage 1	Merciless Labyrinth	Mirror Arrow and Mirror Arrow Clones deal 25% increased Damage
Enchantment Mirror Arrow Damage 2	Eternal Labyrinth	Mirror Arrow and Mirror Arrow Clones deal 40% increased Damage
Enchantment Molten Shell Armour 1	Merciless Labyrinth	100% increased Molten Shell Buff Effect
Enchantment Molten Shell Armour 2	Eternal Labyrinth	150% increased Molten Shell Buff Effect
Enchantment Molten Shell Duration 1	Merciless Labyrinth	Molten Shell has 25% increased Skill Effect Duration
Enchantment Molten Shell Duration 2	Eternal Labyrinth	Molten Shell has 40% increased Skill Effect Duration
Enchantment Molten Strike Damage 1	Merciless Labyrinth	25% increased Molten Strike Damage
Enchantment Molten Strike Damage 2	Eternal Labyrinth	40% increased Molten Strike Damage
Enchantment Molten Strike Num Of Additional Projectiles 1	Merciless Labyrinth	Molten Strike fires an additional Projectile
Enchantment Molten Strike Num Of Additional Projectiles 2	Eternal Labyrinth	Molten Strike fires 2 additional Projectiles
Enchantment Molten Strike Area Of Effect 1	Merciless Labyrinth	16% increased Molten Strike Area of Effect
Enchantment Molten Strike Area Of Effect 2	Eternal Labyrinth	24% increased Molten Strike Area of Effect
Enchantment Pyroclast Mine Damage 1	Merciless Labyrinth	Pyroclast Mine deals 25% increased Damage
Enchantment Pyroclast Mine Damage 2	Eternal Labyrinth	Pyroclast Mine deals 40% increased Damage
Enchantment Pyroclast Mine Additional Projectiles 1	Eternal Labyrinth	Pyroclast Mine fires an additional Projectile
Enchantment Pyroclast Mine Throwing Speed 1	Merciless Labyrinth	Pyroclast Mine has 10% increased Throwing Speed
Enchantment Pyroclast Mine Throwing Speed 2	Eternal Labyrinth	Pyroclast Mine has 15% increased Throwing Speed
Enchantment Orb Of Storms Cast Speed 1	Merciless Labyrinth	Orb of Storms has 20% increased Cast Speed
Enchantment Orb Of Storms Cast Speed 2	Eternal Labyrinth	Orb of Storms has 30% increased Cast Speed
Enchantment Orb Of Storms Damage 1	Merciless Labyrinth	25% increased Orb of Storms Damage
Enchantment Orb Of Storms Damage 2	Eternal Labyrinth	40% increased Orb of Storms Damage
Enchantment Penance Brand Cast Speed 1	Merciless Labyrinth	Penance Brand has 8% increased Cast Speed
Enchantment Penance Brand Cast Speed 2	Eternal Labyrinth	Penance Brand has 12% increased Cast Speed
Enchantment Penance Brand Damage 1	Merciless Labyrinth	Penance Brand deals 25% increased Damage
Enchantment Penance Brand Damage 2	Eternal Labyrinth	Penance Brand deals 40% increased Damage
Enchantment Penance Brand Radius 1	Merciless Labyrinth	Penance Brand has 16% increased Area of Effect
Enchantment Penance Brand Radius 2	Eternal Labyrinth	Penance Brand has 24% increased Area of Effect
Enchantment Perforate Area Of Effect 1	Merciless Labyrinth	Perforate has 16% increased Area of Effect
Enchantment Perforate Area Of Effect 2	Eternal Labyrinth	Perforate has 24% increased Area of Effect
Enchantment Perforate Damage 1	Merciless Labyrinth	Perforate deals 25% increased Damage
Enchantment Perforate Damage 2	Eternal Labyrinth	Perforate deals 40% increased Damage
Enchantment Perforate Number Of Spikes 1	Merciless Labyrinth	Perforate creates +1 Spike
Enchantment Perforate Number Of Spikes 2	Eternal Labyrinth	Perforate creates +2 Spikes
Enchantment Phase Run Duration 1	Merciless Labyrinth	24% increased Phase Run Duration
Enchantment Phase Run Duration 2	Eternal Labyrinth	36% increased Phase Run Duration
Enchantment Phase Run Percent Chance To Not Consume Frenzy Charges 1	Merciless Labyrinth	20% chance for Phase Run to increase Duration without removing Frenzy Charges
Enchantment Phase Run Percent Chance To Not Consume Frenzy Charges 2	Eternal Labyrinth	30% chance for Phase Run to increase Duration without removing Frenzy Charges
Enchantment Physical Cascade Additional Cascades 1	Eternal Labyrinth	Seismic Trap releases an additional Wave
Enchantment Physical Cascade Cooldown Speed 1	Merciless Labyrinth	Seismic Trap has 10% increased Cooldown Recovery Rate
Enchantment Physical Cascade Cooldown Speed 2	Eternal Labyrinth	Seismic Trap has 15% increased Cooldown Recovery Rate
Enchantment Physical Cascade Trap Damage 1	Merciless Labyrinth	Seismic Trap deals 25% increased Damage
Enchantment Physical Cascade Trap Damage 2	Eternal Labyrinth	Seismic Trap deals 40% increased Damage
Enchantment Physical Cascade Trap Duration 1	Merciless Labyrinth	Seismic Trap has 20% increased Skill Effect Duration
Enchantment Physical Cascade Trap Duration 2	Eternal Labyrinth	Seismic Trap has 30% increased Skill Effect Duration
Enchantment Plague Bearer Poison Dot Multiplier While Aura Active 1	Merciless Labyrinth	Plague Bearer Buff grants +12% to Poison Damage over Time Multiplier while Infecting
Enchantment Plague Bearer Poison Dot Multiplier While Aura Active 2	Eternal Labyrinth	Plague Bearer Buff grants +20% to Poison Damage over Time Multiplier while Infecting
Enchantment Plague Bearer Stored Poison Damage To Deal Per Second 1	Merciless Labyrinth	Plague Bearer deals Damage based on an additional 3% of Plague Value
Enchantment Plague Bearer Stored Poison Damage To Deal Per Second 2	Eternal Labyrinth	Plague Bearer deals Damage based on an additional 5% of Plague Value
Enchantment Poachers Mark Curse Effect 1	Merciless Labyrinth	20% increased Poacher's Mark Curse Effect
Enchantment Poachers Mark Curse Effect 2	Eternal Labyrinth	30% increased Poacher's Mark Curse Effect
Enchantment Poachers Mark Duration 1	Merciless Labyrinth	30% increased Poacher's Mark Duration
Enchantment Poachers Mark Duration 2	Eternal Labyrinth	45% increased Poacher's Mark Duration
Enchantment Power Siphon Additional Projectiles 1	Merciless Labyrinth	Power Siphon fires an additional Projectile
Enchantment Power Siphon Additional Projectiles 2	Eternal Labyrinth	Power Siphon fires 2 additional Projectiles
Enchantment Power Siphon Attack Speed 1	Merciless Labyrinth	10% increased Power Siphon Attack Speed
Enchantment Power Siphon Attack Speed 2	Eternal Labyrinth	15% increased Power Siphon Attack Speed
Enchantment Power Siphon Damage 1	Merciless Labyrinth	25% increased Power Siphon Damage
Enchantment Power Siphon Damage 2	Eternal Labyrinth	40% increased Power Siphon Damage
Enchantment Power Siphon Percent Chance To Gain Power Charge On Kill 1	Merciless Labyrinth	30% Chance to gain an additional Power Charge on Kill with Power Siphon
Enchantment Power Siphon Percent Chance To Gain Power Charge On Kill 2	Eternal Labyrinth	45% Chance to gain an additional Power Charge on Kill with Power Siphon
Enchantment Precision Mana Reservation 1	Merciless Labyrinth	Precision has 20% reduced Mana Reservation
Enchantment Precision Mana Reservation 2	Eternal Labyrinth	Precision has 30% reduced Mana Reservation
Enchantment Pride Mana Reservation 1	Merciless Labyrinth	Pride has 10% reduced Mana Reservation
Enchantment Pride Mana Reservation 2	Eternal Labyrinth	Pride has 15% reduced Mana Reservation
Enchantment Projectile Weakness Curse Effect 1	Merciless Labyrinth	Sniper's Mark has 20% increased Curse Effect
Enchantment Projectile Weakness Curse Effect 2	Eternal Labyrinth	Sniper's Mark has 30% increased Curse Effect
Enchantment Projectile Weakness Duration 1	Merciless Labyrinth	Sniper's Mark has 30% increased Duration
Enchantment Projectile Weakness Duration 2	Eternal Labyrinth	Sniper's Mark has 45% increased Duration
Enchantment Puncture Damage 1	Merciless Labyrinth	25% increased Puncture Damage
Enchantment Puncture Damage 2	Eternal Labyrinth	40% increased Puncture Damage
Enchantment Puncture Duration 1	Merciless Labyrinth	30% increased Puncture Duration
Enchantment Puncture Duration 2	Eternal Labyrinth	45% increased Puncture Duration
Enchantment Puncture Maim On Hit Percent Chance 1	Merciless Labyrinth	20% Chance for Puncture to Maim on hit
Enchantment Puncture Maim On Hit Percent Chance 2	Eternal Labyrinth	30% Chance for Puncture to Maim on hit
Enchantment Punishment Curse Effect 1	Merciless Labyrinth	20% increased Punishment Curse Effect
Enchantment Punishment Curse Effect 2	Eternal Labyrinth	30% increased Punishment Curse Effect
Enchantment Punishment Duration 1	Merciless Labyrinth	30% increased Punishment Duration
Enchantment Punishment Duration 2	Eternal Labyrinth	45% increased Punishment Duration
Enchantment Purifying Flame Area Of Effect When Targeting Consecrated Ground 1	Merciless Labyrinth	Purifying Flame has 20% increased Area of Effect if targeting Consecrated Ground
Enchantment Purifying Flame Area Of Effect When Targeting Consecrated Ground 2	Eternal Labyrinth	Purifying Flame has 30% increased Area of Effect if targeting Consecrated Ground
Enchantment Purifying Flame Consecrated Ground Enemy Damage Taken 1	Merciless Labyrinth	Consecrated Ground from Purifying Flame applies 6% increased Damage taken to Enemies
Enchantment Purifying Flame Consecrated Ground Enemy Damage Taken 2	Eternal Labyrinth	Consecrated Ground from Purifying Flame applies 9% increased Damage taken to Enemies
Enchantment Purifying Flame Damage 1	Merciless Labyrinth	Purifying Flame deals 25% increased Damage
Enchantment Purifying Flame Damage 2	Eternal Labyrinth	Purifying Flame deals 40% increased Damage
Enchantment Purity Of Elements Mana Reservation 1	Merciless Labyrinth	Purity of Elements has 14% reduced Mana Reservation
Enchantment Purity Of Elements Mana Reservation 2	Eternal Labyrinth	Purity of Elements has 20% reduced Mana Reservation
Enchantment Purity Of Fire Mana Reservation 1	Merciless Labyrinth	Purity of Fire has 14% reduced Mana Reservation
Enchantment Purity Of Fire Mana Reservation 2	Eternal Labyrinth	Purity of Fire has 20% reduced Mana Reservation
Enchantment Purity Of Ice Mana Reservation 1	Merciless Labyrinth	Purity of Ice has 14% reduced Mana Reservation
Enchantment Purity Of Ice Mana Reservation 2	Eternal Labyrinth	Purity of Ice has 20% reduced Mana Reservation
Enchantment Purity Of Lightning Mana Reservation 1	Merciless Labyrinth	Purity of Lightning has 14% reduced Mana Reservation
Enchantment Purity Of Lightning Mana Reservation 2	Eternal Labyrinth	Purity of Lightning has 20% reduced Mana Reservation
Enchantment Rain Of Arrows Attack Speed 1	Merciless Labyrinth	10% increased Rain of Arrows Attack Speed
Enchantment Rain Of Arrows Attack Speed 2	Eternal Labyrinth	15% increased Rain of Arrows Attack Speed
Enchantment Rain Of Arrows Damage 1	Merciless Labyrinth	25% increased Rain of Arrows Damage
Enchantment Rain Of Arrows Damage 2	Eternal Labyrinth	40% increased Rain of Arrows Damage
Enchantment Rain Of Arrows Area Of Effect 1	Merciless Labyrinth	16% increased Rain of Arrows Area of Effect
Enchantment Rain Of Arrows Area Of Effect 2	Eternal Labyrinth	24% increased Rain of Arrows Area of Effect
Enchantment Rain Of Arrows Repeat Count 1	Merciless Labyrinth	Rain of Arrows has 10% chance to fire an additional sequence of arrows
Enchantment Rain Of Arrows Repeat Count 2	Eternal Labyrinth	Rain of Arrows has 15% chance to fire an additional sequence of arrows
Enchantment Raise Spectre Damage 1	Merciless Labyrinth	Spectres have 25% increased Damage
Enchantment Raise Spectre Damage 2	Eternal Labyrinth	Spectres have 40% increased Damage
Enchantment Raise Zombie Damage 1	Merciless Labyrinth	Raised Zombies deal 25% increased Damage
Enchantment Raise Zombie Damage 2	Eternal Labyrinth	Raised Zombies deal 40% increased Damage
Enchantment Rallying Cry Additional Exert 1	Eternal Labyrinth	Rallying Cry Exerts 1 additional Attack
Enchantment Rallying Cry Buff Effect 1	Merciless Labyrinth	10% increased Rallying Cry Buff Effect
Enchantment Rallying Cry Buff Effect 2	Eternal Labyrinth	15% increased Rallying Cry Buff Effect
Enchantment Reave Damage 1	Merciless Labyrinth	25% increased Reave Damage
Enchantment Reave Damage 2	Eternal Labyrinth	40% increased Reave Damage
Enchantment Reave Area Of Effect 1	Merciless Labyrinth	16% increased Reave Radius
Enchantment Reave Area Of Effect 2	Eternal Labyrinth	24% increased Reave Radius
Enchantment Reckoning Cooldown Speed 1	Merciless Labyrinth	Reckoning has 20% increased Cooldown Recovery Rate
Enchantment Reckoning Cooldown Speed 2	Eternal Labyrinth	Reckoning has 30% increased Cooldown Recovery Rate
Enchantment Reckoning Damage 1	Merciless Labyrinth	25% increased Reckoning Damage
Enchantment Reckoning Damage 2	Eternal Labyrinth	40% increased Reckoning Damage
Enchantment Rejuvination Totem Life Regeneration 1	Merciless Labyrinth	30% increased Rejuvenation Totem Aura Effect
Enchantment Rejuvination Totem Life Regeneration 2	Eternal Labyrinth	45% increased Rejuvenation Totem Aura Effect
Enchantment Rejuvination Totem Percent Life Regeneration Added As Mana Regeneration 1	Merciless Labyrinth	Gain 10% of Rejuvenation Totem Life Regeneration as extra Mana Regeneration
Enchantment Rejuvination Totem Percent Life Regeneration Added As Mana Regeneration 2	Eternal Labyrinth	Gain 15% of Rejuvenation Totem Life Regeneration as extra Mana Regeneration
Enchantment Righteous Fire Damage 1	Merciless Labyrinth	25% increased Righteous Fire Damage
Enchantment Righteous Fire Damage 2	Eternal Labyrinth	40% increased Righteous Fire Damage
Enchantment Righteous Fire Area Of Effect 1	Merciless Labyrinth	16% increased Righteous Fire Area of Effect
Enchantment Righteous Fire Area Of Effect 2	Eternal Labyrinth	24% increased Righteous Fire Area of Effect
Enchantment Righteous Fire Spell Damage 1	Merciless Labyrinth	Righteous Fire grants 20% increased Spell Damage
Enchantment Righteous Fire Spell Damage 2	Eternal Labyrinth	Righteous Fire grants 30% increased Spell Damage
Enchantment Riposte Cooldown Speed 1	Merciless Labyrinth	Riposte has 20% increased Cooldown Recovery Rate
Enchantment Riposte Cooldown Speed 2	Eternal Labyrinth	Riposte has 30% increased Cooldown Recovery Rate
Enchantment Riposte Damage 1	Merciless Labyrinth	25% increased Riposte Damage
Enchantment Riposte Damage 2	Eternal Labyrinth	40% increased Riposte Damage
Enchantment Rune Blast Teleport 1	Merciless Labyrinth	Rune Blast teleports you to the detonated Rune if you have not detonated Runes in the past 1 second
Enchantment Rune Blast Teleport 2	Eternal Labyrinth	Rune Blast teleports you to the detonated Rune if you have not detonated Runes in the past 1.5 seconds
Enchantment Scourge Arrow Additional Spore 1	Eternal Labyrinth	Scourge Arrow creates an additional spore pod at Maximum Stages
Enchantment Scourge Arrow Chance To Poison 1	Merciless Labyrinth	Scourge Arrow has 6% chance to Poison per Stage
Enchantment Scourge Arrow Chance To Poison 2	Eternal Labyrinth	Scourge Arrow has 8% chance to Poison per Stage
Enchantment Scourge Arrow Damage 1	Merciless Labyrinth	Scourge Arrow deals 25% increased Damage
Enchantment Scourge Arrow Damage 2	Eternal Labyrinth	Scourge Arrow deals 40% increased Damage
Enchantment Searing Bond Damage 1	Merciless Labyrinth	25% increased Searing Bond Damage
Enchantment Searing Bond Damage 2	Eternal Labyrinth	40% increased Searing Bond Damage
Enchantment Searing Bond Totem Elemental Resistances 1	Merciless Labyrinth	24% increased Searing Bond Totem Elemental Resistances
Enchantment Searing Bond Totem Elemental Resistances 2	Eternal Labyrinth	36% increased Searing Bond Totem Elemental Resistances
Enchantment Searing Bond Totem Placement Speed 1	Merciless Labyrinth	40% increased Searing Bond Totem Placement Speed
Enchantment Searing Bond Totem Placement Speed 2	Eternal Labyrinth	60% increased Searing Bond Totem Placement Speed
Enchantment Seismic Cry Exerted Attack Damage 1	Merciless Labyrinth	Attacks Exerted by Seismic Cry deal 35% increased Damage
Enchantment Seismic Cry Exerted Attack Damage 2	Eternal Labyrinth	Attacks Exerted by Seismic Cry deal 50% increased Damage
Enchantment Seismic Cry Minimum Power 1	Eternal Labyrinth	Seismic Cry has a minimum of 10 Power
Enchantment Shattering Steel Chance to Not Consume Shards 1	Merciless Labyrinth	Shattering Steel has 20% chance to not consume Steel Shards
Enchantment Shattering Steel Chance to Not Consume Shards 2	Eternal Labyrinth	Shattering Steel has 30% chance to not consume Steel Shards
Enchantment Shattering Steel Damage 1	Merciless Labyrinth	Shattering Steel deals 25% increased Damage
Enchantment Shattering Steel Damage 2	Eternal Labyrinth	Shattering Steel deals 40% increased Damage
Enchantment Shattering Steel Fortify On Hit Close Range 1	Eternal Labyrinth	Shattering Steel grants Fortify on Hitting an Enemy at Close Range
Enchantment Shield Charge Attack Speed 1	Merciless Labyrinth	10% increased Shield Charge Attack Speed
Enchantment Shield Charge Attack Speed 2	Eternal Labyrinth	15% increased Shield Charge Attack Speed
Enchantment Shield Charge Damage 1	Merciless Labyrinth	25% increased Shield Charge Damage
Enchantment Shield Charge Damage 2	Eternal Labyrinth	40% increased Shield Charge Damage
Enchantment Shock Nova Damage 1	Merciless Labyrinth	25% increased Shock Nova Damage
Enchantment Shock Nova Damage 2	Eternal Labyrinth	40% increased Shock Nova Damage
Enchantment Shock Nova Larger Ring Damage 1	Merciless Labyrinth	Shock Nova ring deals 40% increased Damage
Enchantment Shock Nova Larger Ring Damage 2	Eternal Labyrinth	Shock Nova ring deals 60% increased Damage
Enchantment Shock Nova Area Of Effect 1	Merciless Labyrinth	16% increased Shock Nova Area of Effect
Enchantment Shock Nova Area Of Effect 2	Eternal Labyrinth	24% increased Shock Nova Area of Effect
Enchantment Shockwave Totem Cast Speed 1	Merciless Labyrinth	10% increased Shockwave Totem Cast Speed
Enchantment Shockwave Totem Cast Speed 2	Eternal Labyrinth	15% increased Shockwave Totem Cast Speed
Enchantment Shockwave Totem Damage 1	Merciless Labyrinth	25% increased Shockwave Totem Damage
Enchantment Shockwave Totem Damage 2	Eternal Labyrinth	40% increased Shockwave Totem Damage
Enchantment Shockwave Totem Radius 1	Merciless Labyrinth	16% increased Shockwave Totem Area of Effect
Enchantment Shockwave Totem Radius 2	Eternal Labyrinth	24% increased Shockwave Totem Area of Effect
Enchantment Shrapnel Ballista Additional Arrows 1	Eternal Labyrinth	Shrapnel Ballista fires an additional Arrow
Enchantment Shrapnel Ballista Extra Pierces 1	Merciless Labyrinth	Shrapnel Ballista Pierces 4 additional Targets
Enchantment Shrapnel Ballista Extra Pierces 2	Eternal Labyrinth	Shrapnel Ballista Pierces 6 additional Targets
Enchantment Shrapnel Ballista Projectile Speed 1	Merciless Labyrinth	Shrapnel Ballista has 20% increased Projectile Speed
Enchantment Shrapnel Ballista Projectile Speed 2	Eternal Labyrinth	Shrapnel Ballista has 30% increased Projectile Speed
Enchantment Shrapnel Shot Damage 1	Merciless Labyrinth	25% increased Galvanic Arrow Damage
Enchantment Shrapnel Shot Damage 2	Eternal Labyrinth	40% increased Galvanic Arrow Damage
Enchantment Shrapnel Shot Physical Damage Percent To Add As Lightning Damage 1	Merciless Labyrinth	10% of Galvanic Arrow Physical Damage gained as extra Lightning Damage
Enchantment Shrapnel Shot Physical Damage Percent To Add As Lightning Damage 2	Eternal Labyrinth	15% of Galvanic Arrow Physical Damage gained as extra Lightning Damage
Enchantment Shrapnel Trap Damage 1	Merciless Labyrinth	Explosive Trap deals 25% increased Damage
Enchantment Shrapnel Trap Damage 2	Eternal Labyrinth	Explosive Trap deals 40% increased Damage
Enchantment Shrapnel Trap Radius 1	Merciless Labyrinth	Explosive Trap has 16% increased Area of Effect
Enchantment Shrapnel Trap Radius 2	Eternal Labyrinth	Explosive Trap has 24% increased Area of Effect
Enchantment Shrapnel Trap Secondary Explosions 1	Merciless Labyrinth	Explosive Trap causes an additional smaller explosion
Enchantment Shrapnel Trap Secondary Explosions 2	Eternal Labyrinth	Explosive Trap causes 2 additional smaller explosions
Enchantment Siege Ballista Attack Speed 1	Merciless Labyrinth	Siege Ballista has 10% increased Attack Speed
Enchantment Siege Ballista Attack Speed 2	Eternal Labyrinth	Siege Ballista has 15% increased Attack Speed
Enchantment Siege Ballista Damage 1	Merciless Labyrinth	Siege Ballista deals 25% increased Damage
Enchantment Siege Ballista Damage 2	Eternal Labyrinth	Siege Ballista deals 40% increased Damage
Enchantment Siege Ballista Totem Placement Speed 1	Merciless Labyrinth	Siege Ballista has 30% increased Totem Placement Speed
Enchantment Siege Ballista Totem Placement Speed 2	Eternal Labyrinth	Siege Ballista has 45% increased Totem Placement Speed
Enchantment Sigil of Power Critical Strike Chance 1	Merciless Labyrinth	Sigil of Power's Buff also grants 20% increased Critical Strike Chance per Stage
Enchantment Sigil of Power Critical Strike Chance 2	Eternal Labyrinth	Sigil of Power's Buff also grants 30% increased Critical Strike Chance per Stage
Enchantment Sigil of Power Upgrade Cost 1	Merciless Labyrinth	Sigil of Power requires 10% reduced Mana Spent to gain a Stage
Enchantment Sigil of Power Upgrade Cost 2	Eternal Labyrinth	Sigil of Power requires 20% reduced Mana Spent to gain a Stage
Enchantment Dark Pact Area Of Effect 1	Merciless Labyrinth	16% increased Dark Pact Area of Effect
Enchantment Dark Pact Area Of Effect 2	Eternal Labyrinth	24% increased Dark Pact Area of Effect
Enchantment Dack Pact Cast Speed 1	Merciless Labyrinth	8% increased Dark Pact Cast Speed
Enchantment Dack Pact Cast Speed 2	Eternal Labyrinth	12% increased Dark Pact Cast Speed
Enchantment Dark Pact Damage 1	Merciless Labyrinth	25% increased Dark Pact Damage
Enchantment Dark Pact Damage 2	Eternal Labyrinth	40% increased Dark Pact Damage
Enchantment Smite Additional Target Chance 1	Merciless Labyrinth	Smite has a 10% chance for lightning to strike another target
Enchantment Smite Additional Target Chance 2	Eternal Labyrinth	Smite has a 15% chance for lightning to strike another target
Enchantment Smite Aura Effect 1	Merciless Labyrinth	Smite has 20% increased Aura Effect
Enchantment Smite Aura Effect 2	Eternal Labyrinth	Smite has 30% increased Aura Effect
Enchantment Smite Damage 1	Merciless Labyrinth	Smite deals 25% increased Damage
Enchantment Smite Damage 2	Eternal Labyrinth	Smite deals 40% increased Damage
Enchantment Smoke Mine Duration 1	Merciless Labyrinth	20% increased Smoke Mine Duration
Enchantment Smoke Mine Duration 2	Eternal Labyrinth	30% increased Smoke Mine Duration
Enchantment Smoke Mine Movement Speed 1	Merciless Labyrinth	Smoke Mine grants additional 20% increased Movement Speed
Enchantment Smoke Mine Movement Speed 2	Eternal Labyrinth	Smoke Mine grants additional 30% increased Movement Speed
Enchantment Venom Gyre Chance To Retain Projectile On Release 2	Eternal Labyrinth	Venom Gyre has a 25% chance to keep caught Projectiles fired by using Whirling Blades
Enchantment Venom Gyre Damage 1	Merciless Labyrinth	Venom Gyre deals 25% increased Damage
Enchantment Venom Gyre Damage 2	Eternal Labyrinth	Venom Gyre deals 40% increased Damage
Enchantment Venom Gyre Withering On Hit Chance 1	Merciless Labyrinth	Venom Gyre has a 12% chance to inflict Withered for 2 seconds on Hit
Enchantment Venom Gyre Withering On Hit Chance 2	Eternal Labyrinth	Venom Gyre has a 20% chance to inflict Withered for 2 seconds on Hit
Enchantment Soulrend Applies Hinder Movement Speed 1	Merciless Labyrinth	Soulrend also Hinders Enemies, with 25% reduced Movement Speed
Enchantment Soulrend Applies Hinder Movement Speed 2	Eternal Labyrinth	Soulrend also Hinders Enemies, with 40% reduced Movement Speed
Enchantment Soulrend Damage 1	Merciless Labyrinth	Soulrend deals 25% increased Damage
Enchantment Soulrend Damage 2	Eternal Labyrinth	Soulrend deals 40% increased Damage
Enchantment Soulrend Number Of Additional Projectiles 1	Eternal Labyrinth	Soulrend fires an additional Projectile
Enchantment Spark Damage 1	Merciless Labyrinth	25% increased Spark Damage
Enchantment Spark Damage 2	Eternal Labyrinth	40% increased Spark Damage
Enchantment Spark Num Of Additional Projectiles 1	Merciless Labyrinth	Spark fires 2 additional Projectiles
Enchantment Spark Num Of Additional Projectiles 2	Eternal Labyrinth	Spark fires 3 additional Projectiles
Enchantment Spark Projectile Speed 1	Merciless Labyrinth	20% increased Spark Projectile Speed
Enchantment Spark Projectile Speed 2	Eternal Labyrinth	30% increased Spark Projectile Speed
Enchantment Spectral Shield Throw Damage 1	Merciless Labyrinth	25% increased Spectral Shield Throw Damage
Enchantment Spectral Shield Throw Damage 2	Eternal Labyrinth	40% increased Spectral Shield Throw Damage
Enchantment Spectral Shield Throw Num Of Additional Projectiles 1	Merciless Labyrinth	Spectral Shield Throw fires 3 additional Shard Projectiles
Enchantment Spectral Shield Throw Num Of Additional Projectiles 2	Eternal Labyrinth	Spectral Shield Throw fires 5 additional Shard Projectiles
Enchantment Spectral Shield Throw Projectile Speed 1	Merciless Labyrinth	20% increased Spectral Shield Throw Projectile Speed
Enchantment Spectral Shield Throw Projectile Speed 2	Eternal Labyrinth	30% increased Spectral Shield Throw Projectile Speed
Enchantment Spectral Throw Damage 1	Merciless Labyrinth	25% increased Spectral Throw Damage
Enchantment Spectral Throw Damage 2	Eternal Labyrinth	40% increased Spectral Throw Damage
Enchantment Spectral Throw Projectile Deceleration 1	Merciless Labyrinth	20% reduced Spectral Throw Projectile Deceleration
Enchantment Spectral Throw Projectile Deceleration 2	Eternal Labyrinth	30% reduced Spectral Throw Projectile Deceleration
Enchantment Spectral Throw Projectile Speed 1	Merciless Labyrinth	20% increased Spectral Throw Projectile Speed
Enchantment Spectral Throw Projectile Speed 2	Eternal Labyrinth	30% increased Spectral Throw Projectile Speed
Enchantment Spectre Attack And Cast Speed 1	Merciless Labyrinth	Spectres have 8% increased Attack and Cast Speed
Enchantment Spectre Attack And Cast Speed 2	Eternal Labyrinth	Spectres have 12% increased Attack and Cast Speed
Enchantment Spectre Elemental Resistances 1	Merciless Labyrinth	+24% to Raised Spectre Elemental Resistances
Enchantment Spectre Elemental Resistances 2	Eternal Labyrinth	+36% to Raised Spectre Elemental Resistances
Enchantment Spellslinger Cooldown Recovery 1	Merciless Labyrinth	Skills Supported by Spellslinger have 20% increased Cooldown Recovery Rate
Enchantment Spellslinger Cooldown Recovery 2	Eternal Labyrinth	Skills Supported by Spellslinger have 30% increased Cooldown Recovery Rate
Enchantment Spellslinger Reservation 1	Merciless Labyrinth	Skills Supported by Spellslinger have 10% reduced Mana Reservation
Enchantment Spellslinger Reservation 2	Eternal Labyrinth	Skills Supported by Spellslinger have 15% reduced Mana Reservation
Enchantment Spirit Offering Duration 1	Merciless Labyrinth	30% increased Spirit Offering Duration
Enchantment Spirit Offering Duration 2	Eternal Labyrinth	45% increased Spirit Offering Duration
Enchantment Spirit Offering Physical Added As Chaos 1	Merciless Labyrinth	Spirit Offering grants +8% of Physical Damage as Extra Chaos Damage
Enchantment Spirit Offering Physical Added As Chaos 2	Eternal Labyrinth	Spirit Offering grants +12% of Physical Damage as Extra Chaos Damage
Enchantment Split Arrow Critical Strike Chance 1	Merciless Labyrinth	60% increased Split Arrow Critical Strike Chance
Enchantment Split Arrow Critical Strike Chance 2	Eternal Labyrinth	90% increased Split Arrow Critical Strike Chance
Enchantment Split Arrow Damage 1	Merciless Labyrinth	25% increased Split Arrow Damage
Enchantment Split Arrow Damage 2	Eternal Labyrinth	40% increased Split Arrow Damage
Enchantment Split Arrow Num Of Additional Projectiles 1	Merciless Labyrinth	Split Arrow fires 2 additional Projectiles
Enchantment Split Arrow Num Of Additional Projectiles 2	Eternal Labyrinth	Split Arrow fires 3 additional Projectiles
Enchantment Splitting Steel Area 1	Merciless Labyrinth	Splitting Steel has 16% increased Area of Effect
Enchantment Splitting Steel Area 2	Eternal Labyrinth	Splitting Steel has 24% increased Area of Effect
Enchantment Splitting Steel Chance to Not Consume Shard 1	Merciless Labyrinth	Splitting Steel has 20% chance to not consume Steel Shards
Enchantment Splitting Steel Chance to Not Consume Shard 2	Eternal Labyrinth	Splitting Steel has 30% chance to not consume Steel Shards
Enchantment Splitting Steel 1	Merciless Labyrinth	Splitting Steel deals 25% increased Damage
Enchantment Splitting Steel 2	Eternal Labyrinth	Splitting Steel deals 40% increased Damage
Enchantment Static Strike Damage 1	Merciless Labyrinth	25% increased Static Strike Damage
Enchantment Static Strike Damage 2	Eternal Labyrinth	40% increased Static Strike Damage
Enchantment Static Strike Duration 1	Merciless Labyrinth	30% increased Static Strike Duration
Enchantment Static Strike Duration 2	Eternal Labyrinth	45% increased Static Strike Duration
Enchantment Static Strike Maximum Beam Targets 1	Merciless Labyrinth	Static Strike has +1 maximum Beam Targets
Enchantment Static Strike Maximum Beam Targets 2	Eternal Labyrinth	Static Strike has +2 maximum Beam Targets
Enchantment Static Strike Area Of Effect 1	Merciless Labyrinth	16% increased Static Strike Area of Effect
Enchantment Static Strike Area Of Effect 2	Eternal Labyrinth	24% increased Static Strike Area of Effect
Enchantment Steelskin Additional Physical Damage Reduction 1	Merciless Labyrinth	Steelskin grants 8% additional Physical Damage Reduction
Enchantment Steelskin Additional Physical Damage Reduction 2	Eternal Labyrinth	Steelskin grants 12% additional Physical Damage Reduction
Enchantment Steelskin Damage Limit 1	Merciless Labyrinth	Steelskin Buff can take 30% increased amount of Damage
Enchantment Steelskin Damage Limit 2	Eternal Labyrinth	Steelskin Buff can take 45% increased amount of Damage
Enchantment Stone Golem Elemental Resistances 1	Merciless Labyrinth	+24% to Stone Golem Elemental Resistances
Enchantment Stone Golem Elemental Resistances 2	Eternal Labyrinth	+36% to Stone Golem Elemental Resistances
Enchantment Stone Golem Granted Buff Effect 1	Merciless Labyrinth	100% increased Effect of the Buff granted by your Stone Golems
Enchantment Stone Golem Granted Buff Effect 2	Eternal Labyrinth	150% increased Effect of the Buff granted by your Stone Golems
Enchantment Stormbind Area of Effect 1	Merciless Labyrinth	Stormbind has 16% increased Area of Effect
Enchantment Stormbind Area of Effect 2	Eternal Labyrinth	Stormbind has 24% increased Area of Effect
Enchantment Stormbind Damage 1	Merciless Labyrinth	Stormbind deals 25% increased Damage
Enchantment Stormbind Damage 2	Eternal Labyrinth	Stormbind deals 40% increased Damage
Enchantment Storm Brand Damage 1	Merciless Labyrinth	Storm Brand deals 25% increased Damage
Enchantment Storm Brand Damage 2	Eternal Labyrinth	Storm Brand deals 40% increased Damage
Enchantment Storm Burst Additional Object Chance 1	Merciless Labyrinth	Storm Burst has a 10% chance to create an additional Orb
Enchantment Storm Burst Additional Object Chance 2	Eternal Labyrinth	Storm Burst has a 15% chance to create an additional Orb
Enchantment Storm Burst Damage 1	Merciless Labyrinth	25% increased Storm Burst Damage
Enchantment Storm Burst Damage 2	Eternal Labyrinth	40% increased Storm Burst Damage
Enchantment Storm Burst Area Of Effect 1	Merciless Labyrinth	16% increased Storm Burst Area of Effect
Enchantment Storm Burst Area Of Effect 2	Eternal Labyrinth	24% increased Storm Burst Area of Effect
Enchantment Storm Call Damage 1	Merciless Labyrinth	25% increased Storm Call Damage
Enchantment Storm Call Damage 2	Eternal Labyrinth	40% increased Storm Call Damage
Enchantment Storm Call Duration 1	Merciless Labyrinth	20% reduced Storm Call Duration
Enchantment Storm Call Duration 2	Eternal Labyrinth	30% reduced Storm Call Duration
Enchantment Storm Call Area Of Effect 1	Merciless Labyrinth	16% increased Storm Call Area of Effect
Enchantment Storm Call Area Of Effect 2	Eternal Labyrinth	24% increased Storm Call Area of Effect
Enchantment Orb of Storms Critical Strike Chance 1	Merciless Labyrinth	60% increased Orb of Storms Critical Strike Chance
Enchantment Orb of Storms Critical Strike Chance 2	Eternal Labyrinth	90% increased Orb of Storms Critical Strike Chance
Enchantment Orb of Storms Area Of Effect 1	Merciless Labyrinth	16% increased Orb of Storms Area of Effect
Enchantment Orb of Storms Area Of Effect 2	Eternal Labyrinth	24% increased Orb of Storms Area of Effect
Enchantment Summoned Raging Spirit Additional 1	Merciless Labyrinth	Summon Raging Spirit has 12% chance to summon an extra Minion
Enchantment Summoned Raging Spirit Additional 2	Eternal Labyrinth	Summon Raging Spirit has 18% chance to summon an extra Minion
Enchantment Summoned Raging Spirit Duration 1	Merciless Labyrinth	Summon Raging Spirit has 20% increased Duration
Enchantment Summoned Raging Spirit Duration 2	Eternal Labyrinth	Summon Raging Spirit has 30% increased Duration
Enchantment Summon Flame Golem Damage 1	Merciless Labyrinth	Flame Golems have 25% increased Damage
Enchantment Summon Flame Golem Damage 2	Eternal Labyrinth	Flame Golems have 40% increased Damage
Enchantment Summon Ice Golem Damage 1	Merciless Labyrinth	Ice Golems deal 25% increased Damage
Enchantment Summon Ice Golem Damage 2	Eternal Labyrinth	Ice Golems deal 40% increased Damage
Enchantment Summon Lightning Golem Damage 1	Merciless Labyrinth	Lightning Golems deal 25% increased Damage
Enchantment Summon Lightning Golem Damage 2	Eternal Labyrinth	Lightning Golems deal 40% increased Damage
Enchantment Summon Raging Spirit Damage 1	Merciless Labyrinth	Summoned Raging Spirits deal 25% increased Damage
Enchantment Summon Raging Spirit Damage 2	Eternal Labyrinth	Summoned Raging Spirits deal 40% increased Damage
Enchantment Summon Skeletons Damage 1	Merciless Labyrinth	Skeletons deal 25% increased Damage
Enchantment Summon Skeletons Damage 2	Eternal Labyrinth	Skeletons deal 40% increased Damage
Enchantment Summon Skeletons Additional Warrior Skeletons 1	Merciless Labyrinth	20% chance to Summon an additional Skeleton Warrior with Summon Skeleton
Enchantment Summon Skeletons Additional Warrior Skeletons 2	Eternal Labyrinth	40% chance to Summon an additional Skeleton Warrior with Summon Skeleton
Enchantment Summon Skitterbots Area Of Effect 1	Merciless Labyrinth	Summoned Skitterbots have 60% increased Area of Effect
Enchantment Summon Skitterbots Area Of Effect 2	Eternal Labyrinth	Summoned Skitterbots have 90% increased Area of Effect
Enchantment Summon Skitterbots Mana Reservation 1	Merciless Labyrinth	Summon Skitterbots has 14% reduced Mana Reservation
Enchantment Summon Skitterbots Mana Reservation 2	Eternal Labyrinth	Summon Skitterbots has 20% reduced Mana Reservation
Enchantment Summon Stone Golem Damage 1	Merciless Labyrinth	Stone Golems deal 25% increased Damage
Enchantment Summon Stone Golem Damage 2	Eternal Labyrinth	Stone Golems deal 40% increased Damage
Enchantment Sumon Chaos Golem Damage 1	Merciless Labyrinth	Chaos Golems deal 25% increased Damage
Enchantment Sumon Chaos Golem Damage 2	Eternal Labyrinth	Chaos Golems deal 40% increased Damage
Enchantment Sunder Damage 1	Merciless Labyrinth	Sunder has 25% increased Damage
Enchantment Sunder Damage 2	Eternal Labyrinth	Sunder has 40% increased Damage
Enchantment Sunder Radius 1	Merciless Labyrinth	Sunder has 16% increased Area of Effect
Enchantment Sunder Radius 2	Eternal Labyrinth	Sunder has 24% increased Area of Effect
Enchantment Sunder Wave Speed 1	Merciless Labyrinth	Sunder has 15% reduced delay between Areas in the Wave
Enchantment Sunder Wave Speed 2	Eternal Labyrinth	Sunder has 20% reduced delay between Areas in the Wave
Enchantment Sweep Damage 1	Merciless Labyrinth	25% increased Sweep Damage
Enchantment Sweep Damage 2	Eternal Labyrinth	40% increased Sweep Damage
Enchantment Sweep Endurance Charge on Hit Chance 1	Merciless Labyrinth	Sweep has a 20% chance to grant an Endurance Charge on Hit
Enchantment Sweep Endurance Charge on Hit Chance 2	Eternal Labyrinth	Sweep has a 30% chance to grant an Endurance Charge on Hit
Enchantment Sweep Area Of Effect 1	Merciless Labyrinth	16% increased Sweep Area of Effect
Enchantment Sweep Area Of Effect 2	Eternal Labyrinth	24% increased Sweep Area of Effect
Enchantment Tectonic Slam Area Of Effect 1	Merciless Labyrinth	Tectonic Slam has 16% increased Area of Effect
Enchantment Tectonic Slam Area Of Effect 2	Eternal Labyrinth	Tectonic Slam has 24% increased Area of Effect
Enchantment Tectonic Slam Chance For Side Crack 1	Merciless Labyrinth	Tectonic Slam has +12% fissure branching chance
Enchantment Tectonic Slam Chance For Side Crack 2	Eternal Labyrinth	Tectonic Slam has +20% fissure branching chance
Enchantment Tectonic Slam Damage 1	Merciless Labyrinth	Tectonic Slam deals 25% increased Damage
Enchantment Tectonic Slam Damage 2	Eternal Labyrinth	Tectonic Slam deals 40% increased Damage
Enchantment Tempest Shield Damage 1	Merciless Labyrinth	25% increased Tempest Shield Damage
Enchantment Tempest Shield Damage 2	Eternal Labyrinth	40% increased Tempest Shield Damage
Enchantment Tempest Shield Num Of Additional Projectiles In Chain 1	Merciless Labyrinth	Tempest Shield chains an additional 2 times
Enchantment Tempest Shield Num Of Additional Projectiles In Chain 2	Eternal Labyrinth	Tempest Shield chains an additional 3 times
Enchantment Temporal Chains Curse Effect 1	Merciless Labyrinth	20% increased Temporal Chains Curse Effect
Enchantment Temporal Chains Curse Effect 2	Eternal Labyrinth	30% increased Temporal Chains Curse Effect
Enchantment Temporal Chains Duration 1	Merciless Labyrinth	30% increased Temporal Chains Duration
Enchantment Temporal Chains Duration 2	Eternal Labyrinth	45% increased Temporal Chains Duration
Enchantment Tornado Shot Critical Strike Chance 1	Merciless Labyrinth	60% increased Tornado Shot Critical Strike Chance
Enchantment Tornado Shot Critical Strike Chance 2	Eternal Labyrinth	90% increased Tornado Shot Critical Strike Chance
Enchantment Tornado Shot Damage 1	Merciless Labyrinth	25% increased Tornado Shot Damage
Enchantment Tornado Shot Damage 2	Eternal Labyrinth	40% increased Tornado Shot Damage
Enchantment Tornado Shot Num Of Secondary Projectiles 2	Eternal Labyrinth	Tornado Shot fires an additional secondary Projectile
Enchantment Toxic Rain Damage 1	Merciless Labyrinth	Toxic Rain deals 25% increased Damage
Enchantment Toxic Rain Damage 2	Eternal Labyrinth	Toxic Rain deals 40% increased Damage
Enchantment Toxic Rain Num Of Additional Projectiles 1	Eternal Labyrinth	Toxic Rain fires 1 additional Arrow
Enchantment Toxic Rain Physical Added As Chaos 1	Merciless Labyrinth	Toxic Rain gains 6% of Physical Damage as Extra Chaos Damage
Enchantment Toxic Rain Physical Added As Chaos 2	Eternal Labyrinth	Toxic Rain gains 10% of Physical Damage as Extra Chaos Damage
Enchantment Vengeance Cooldown Speed 1	Merciless Labyrinth	Vengeance has 20% increased Cooldown Recovery Rate
Enchantment Vengeance Cooldown Speed 2	Eternal Labyrinth	Vengeance has 30% increased Cooldown Recovery Rate
Enchantment Vengeance Damage 1	Merciless Labyrinth	25% increased Vengeance Damage
Enchantment Vengeance Damage 2	Eternal Labyrinth	40% increased Vengeance Damage
Enchantment Vigilant Strike Damage 1	Merciless Labyrinth	25% increased Vigilant Strike Damage
Enchantment Vigilant Strike Damage 2	Eternal Labyrinth	40% increased Vigilant Strike Damage
Enchantment Vigilant Strike Fortify Duration 1	Merciless Labyrinth	30% increased Vigilant Strike Fortify Duration
Enchantment Vigilant Strike Fortify Duration 2	Eternal Labyrinth	45% increased Vigilant Strike Fortify Duration
Enchantment Viper Strike Critical Strike Chance 1	Merciless Labyrinth	60% increased Viper Strike Critical Strike Chance
Enchantment Viper Strike Critical Strike Chance 2	Eternal Labyrinth	90% increased Viper Strike Critical Strike Chance
Enchantment Viper Strike Damage 1	Merciless Labyrinth	25% increased Viper Strike Damage
Enchantment Viper Strike Damage 2	Eternal Labyrinth	40% increased Viper Strike Damage
Enchantment Viper Strike Poison Duration 1	Merciless Labyrinth	20% increased Viper Strike Duration
Enchantment Viper Strike Poison Duration 2	Eternal Labyrinth	30% increased Viper Strike Duration
Enchantment Vitality Mana Reservation 1	Merciless Labyrinth	Vitality has 20% reduced Mana Reservation
Enchantment Vitality Mana Reservation 2	Eternal Labyrinth	Vitality has 30% reduced Mana Reservation
Enchantment Void Sphere Cooldown 1	Merciless Labyrinth	Void Sphere has 20% increased Cooldown Recovery Rate
Enchantment Void Sphere Cooldown 2	Eternal Labyrinth	Void Sphere has 30% increased Cooldown Recovery Rate
Enchantment Void Sphere Damage Taken 1	Merciless Labyrinth	Enemies in Void Sphere's range take up to 6% increased Damage, based on distance from the Void Sphere
Enchantment Void Sphere Damage Taken 2	Eternal Labyrinth	Enemies in Void Sphere's range take up to 10% increased Damage, based on distance from the Void Sphere
Enchantment Void Sphere Pulse Rate 1	Merciless Labyrinth	Void Sphere has 12% increased Pulse Frequency
Enchantment Void Sphere Pulse Rate 2	Eternal Labyrinth	Void Sphere has 18% increased Pulse Frequency
Enchantment Volatile Dead Cast Speed 1	Merciless Labyrinth	8% increased Volatile Dead Cast Speed
Enchantment Volatile Dead Cast Speed 2	Eternal Labyrinth	12% increased Volatile Dead Cast Speed
Enchantment Volatile Dead Damage 1	Merciless Labyrinth	25% increased Volatile Dead Damage
Enchantment Volatile Dead Damage 2	Eternal Labyrinth	40% increased Volatile Dead Damage
Enchantment Volatile Dead Orbs 3	Eternal Labyrinth	Volatile Dead Consumes up to 1 additional corpse
Enchantment Vortex AoE On Frostbolt 1	Merciless Labyrinth	Vortex has 30% increased Area of Effect when Cast on Frostbolt
Enchantment Vortex AoE On Frostbolt 2	Eternal Labyrinth	Vortex has 45% increased Area of Effect when Cast on Frostbolt
Enchantment Vortex Cooldown Recovery 1	Merciless Labyrinth	Vortex has 20% increased Cooldown Recovery Rate
Enchantment Vortex Cooldown Recovery 2	Eternal Labyrinth	Vortex has 30% increased Cooldown Recovery Rate
Enchantment Vortex Damage 1	Merciless Labyrinth	25% increased Vortex Damage
Enchantment Vortex Damage 2	Eternal Labyrinth	40% increased Vortex Damage
Enchantment Vortex Duration 1	Merciless Labyrinth	20% increased Vortex Duration
Enchantment Vortex Duration 2	Eternal Labyrinth	30% increased Vortex Duration
Enchantment Vulnerability Curse Effect 1	Merciless Labyrinth	20% increased Vulnerability Curse Effect
Enchantment Vulnerability Curse Effect 2	Eternal Labyrinth	30% increased Vulnerability Curse Effect
Enchantment Vulnerability Duration 1	Merciless Labyrinth	30% increased Vulnerability Duration
Enchantment Vulnerability Duration 2	Eternal Labyrinth	45% increased Vulnerability Duration
Enchantment War Banner Effect 1	Merciless Labyrinth	War Banner has 25% increased Aura Effect
Enchantment War Banner Effect 2	Eternal Labyrinth	War Banner has 40% increased Aura Effect
Enchantment Warlords Mark Curse Effect 1	Merciless Labyrinth	20% increased Warlord's Mark Curse Effect
Enchantment Warlords Mark Curse Effect 2	Eternal Labyrinth	30% increased Warlord's Mark Curse Effect
Enchantment Warlords Mark Duration 1	Merciless Labyrinth	30% increased Warlord's Mark Duration
Enchantment Warlords Mark Duration 2	Eternal Labyrinth	45% increased Warlord's Mark Duration
Enchantment Wave Of Conviction Additional Enemy Resistance 1	Merciless Labyrinth	Wave of Conviction's Exposure applies -4% Elemental Resistance
Enchantment Wave Of Conviction Additional Enemy Resistance 2	Eternal Labyrinth	Wave of Conviction's Exposure applies -6% Elemental Resistance
Enchantment Wave Of Conviction Damage 1	Merciless Labyrinth	Wave of Conviction deals 25% increased Damage
Enchantment Wave Of Conviction Damage 2	Eternal Labyrinth	Wave of Conviction deals 40% increased Damage
Enchantment Wave Of Conviction Duration 1	Merciless Labyrinth	Wave of Conviction has 20% increased Duration
Enchantment Wave Of Conviction Duration 2	Eternal Labyrinth	Wave of Conviction has 30% increased Duration
Enchantment Whirling Blades Attack Speed 1	Merciless Labyrinth	10% increased Whirling Blades Attack Speed
Enchantment Whirling Blades Attack Speed 2	Eternal Labyrinth	15% increased Whirling Blades Attack Speed
Enchantment Whirling Blades Damage 1	Merciless Labyrinth	25% increased Whirling Blades Damage
Enchantment Whirling Blades Damage 2	Eternal Labyrinth	40% increased Whirling Blades Damage
Enchantment Wild Strike Damage 1	Merciless Labyrinth	25% increased Wild Strike Damage
Enchantment Wild Strike Damage 2	Eternal Labyrinth	40% increased Wild Strike Damage
Enchantment Wild Strike Num Of Additional Projectiles In Chain 1	Merciless Labyrinth	Wild Strike's Beam Chains an additional 4 times
Enchantment Wild Strike Num Of Additional Projectiles In Chain 2	Eternal Labyrinth	Wild Strike's Beam Chains an additional 6 times
Enchantment Wild Strike Area Of Effect 1	Merciless Labyrinth	24% increased Wild Strike Area of Effect
Enchantment Wild Strike Area Of Effect 2	Eternal Labyrinth	36% increased Wild Strike Area of Effect
Enchantment Winter Brand Chill Efffect 1	Merciless Labyrinth	Wintertide Brand has 25% increased Chill Effect
Enchantment Winter Brand Chill Efffect 2	Eternal Labyrinth	Wintertide Brand has 40% increased Chill Effect
Enchantment Winter Brand Damage 1	Merciless Labyrinth	Wintertide Brand deals 25% increased Damage
Enchantment Winter Brand Damage 2	Eternal Labyrinth	Wintertide Brand deals 40% increased Damage
Enchantment Winter Brand Stages 1	Merciless Labyrinth	Wintertide Brand has +2 to maximum Stages
Enchantment Winter Brand Stages 2	Eternal Labyrinth	Wintertide Brand has +4 to maximum Stages
Enchantment Winter Orb Damage 1	Merciless Labyrinth	Winter Orb deals 25% increased Damage
Enchantment Winter Orb Damage 2	Eternal Labyrinth	Winter Orb deals 40% increased Damage
Enchantment Wither Duration 1	Merciless Labyrinth	Wither has 24% increased Duration
Enchantment Wither Duration 2	Eternal Labyrinth	Wither has 36% increased Duration
Enchantment Withering Step Elusive Effect 1	Merciless Labyrinth	Withering Step has 20% increased Elusive Effect
Enchantment Withering Step Elusive Effect 2	Eternal Labyrinth	Withering Step has 30% increased Elusive Effect
Enchantment Withering Step Wither Stacks1	Merciless Labyrinth	Withering Step inflicts 2 additional Withered Debuffs
Enchantment Withering Step Wither Stacks 2	Eternal Labyrinth	Withering Step inflicts 3 additional Withered Debuffs
Enchantment Wither Area Of Effect 1	Merciless Labyrinth	Wither has 16% increased Area of Effect
Enchantment Wither Area Of Effect 2	Eternal Labyrinth	Wither has 24% increased Area of Effect
Enchantment Wrath Mana Reservation 1	Merciless Labyrinth	Wrath has 10% reduced Mana Reservation
Enchantment Wrath Mana Reservation 2	Eternal Labyrinth	Wrath has 15% reduced Mana Reservation
Enchantment Zealotry Mana Reservation 1	Merciless Labyrinth	Zealotry has 10% reduced Mana Reservation
Enchantment Zealotry Mana Reservation 2	Eternal Labyrinth	Zealotry has 15% reduced Mana Reservation
Enchantment Zombie Attack Speed 1	Merciless Labyrinth	Raised Zombies have 10% increased Attack Speed
Enchantment Zombie Attack Speed 2	Eternal Labyrinth	Raised Zombies have 15% increased Attack Speed
Enchantment Zombie Elemental Resistances 1	Merciless Labyrinth	Raised Zombies have +24% to Elemental Resistances
Enchantment Zombie Elemental Resistances 2	Eternal Labyrinth	Raised Zombies have +36% to Elemental Resistances
Storm Brand Additional Chain Chance 1	Merciless Labyrinth	Storm Brand has a 12% chance to Chain an additional time
Storm Brand Additional Chain Chance 2	Eternal Labyrinth	Storm Brand has a 18% chance to Chain an additional time
Storm Brand Attached Target Lightning Penetration 1	Merciless Labyrinth	Storm Brand Damage Penetrates 8% of Branded Enemy's Lightning Resistance
Storm Brand Attached Target Lightning Penetration 2	Eternal Labyrinth	Storm Brand Damage Penetrates 12% of Branded Enemy's Lightning Resistance
EnchantmentArcaneSurge	Belt Labyrinth	15% increased Area of Effect while you have Arcane Surge
EnchantmentBlind	Belt Labyrinth	Enemies Blinded by you have 30% reduced Critical Strike Chance
EnchantmentConsecratedGround	Belt Labyrinth	30% reduced Effect of Curses on you while on Consecrated Ground
EnchantmentElusive	Belt Labyrinth	20% chance to Avoid Elemental Ailments while you have Elusive
EnchantmentExposure	Belt Labyrinth	Elemental Ailments inflicted on Enemies Exposed by you have 20% increased Duration
EnchantmentFortify_	Belt Labyrinth	+300 to Armour while you have Fortify
EnchantmentHinder	Belt Labyrinth	Enemies Hindered by you have 50% reduced Life Regeneration rate
EnchantmentIntimidate	Belt Labyrinth	Enemies Intimidated by you have 20% increased duration of stuns against them
EnchantmentMaim	Belt Labyrinth	Enemies Maimed by you take 8% increased Damage Over Time
EnchantmentOnslaught_	Belt Labyrinth	30% increased Accuracy Rating while you have Onslaught
EnchantmentPhasing__	Belt Labyrinth	+300 to Evasion Rating while you have Phasing
EnchantmentRage_	Belt Labyrinth	Recover 2% of Life when you Kill an Enemy while you have Rage
EnchantmentTaunt	Belt Labyrinth	Enemies Taunted by you deal 5% less Area Damage
EnchantmentUnnerve	Belt Labyrinth	Hits against Enemies Unnerved by you have 50% increased Spell Critical Strike Chance
EnchantmentWither_	Belt Labyrinth	Enemies Withered by you have -6% to all Resistances
